Gs^Fds, Gs^Fds, Gs^Fds, Gs^Fds, Gs^Fds, Gs^Fds, Gs^Fds, Gs^Fds, Gs^Fds, Gs^Fds, Gs^Fds, Gs^Fds, Gs^Fds, Gs^Fds, Gs^Fds, Gs^Fds, Gs^Fds, Hh, Hh, Hh, Hh, Gs^Fds
Gs^Fds, Gs^Fds, Gs^Fds, Gs^Fds, Gll^Fdf, Gll^Fdf, Gll, Gs^Fds, Gll^Fdf, Gs^Fds, Gll^Fdf, Gs^Fds, Gll^Fdf, Gll^Fdf, Gll, Gs^Fds, Gll^Fdf, Gs^Fds, Gs^Fds, Hh, Hh, Hh
Gs^Fds, Gs^Fds, Gs^Fds, Gll^Fdf, Gll^Fdf, Gll, Gg^Fet, Gll, Gs^Fds, Gll^Fdf, Gs^Fds, Hh, Hh, Hh, Gs^Fds, Gll, Gll, Gll^Fdf, Gs^Fds, Gs^Fds, Hh, Hh
Gs^Fds, Gs^Fds, Gs^Fds, Gll, Gll, Gs^Fds, Gg^Efm, Gll^Fdf, Gll^Fdf, Gs^Fds, Gs^Fds, Hh, Gs^Fds, Gs^Fds, Gs^Fds, Gs^Fds, Gs^Fds, Gll, Gll, Hh, Hh, Hh
Gs^Fds, Gs^Fds, Gll^Fdf, Gll^Fdf, Gs^Fds, Gs^Fds, Gs, Gg^Efm, Gg^Efm, Gs^Fds, Gs^Fds, Hh, Hh^Vhh, Hh, Gs^Fds, Gll, Gll, Gll, Hh, Hh, Hh, Gs^Fds
Gs^Fds, Cv, Cv, Gs^Fds, Re, Gs^Fds, Gll^Fdf, Gs, Gd, Gg, Gg, Gs, Gg, Gg^Efm, Gg, Gg, Gll^Fdf, Gll^Fdf, Hh, Hh^Vhh, Gs^Fds, Gs^Fds
Re, Kv, Re, Re, Re, Re, Re, Re, Re, Gd, Gs, Gs, Gd, Gg, Gd, Gll^Fdf, Gs, Gg, Gll^Fdf, Hh, Gs^Fds, Gs^Fds
Re, 1 Re, Re, Re, Gs^Fds, Gs^Fds, Gs^Fds, Re, Gg, Gs, Gd, Gd, Gg^Ve, Gd, Gg, Gs, Gs^Fds, Gs^Fds, Gll^Fdf, Gs^Fds, Gs^Fds, Gs^Fds
Gs^Fds, 2 Re, Cv, Gs^Fds, Gg^Efm, Gs^Fds, Gs, Gll^Fdf, Gs, Gs, Gs, Gd, Gd, Gg, Gg^Efm, Gg, Gg, Gll^Fdf, Gll, Gs^Fds, Gs^Fds, Gs^Fds
Gs^Fds, Kv, Cv, Gll, Gll, Gs, Gs^Fds, Gs, Gll^Fdf, Gs, Gd, Gd, Gs, Gg, Gg^Efm, Gll^Fdf, Gs^Fds, Gg, Gg^Efm, Gll, Gll^Fdf, Gs^Fds
Gs^Fds, Cv, Gll^Fdf, Gll, Gll, Gll^Fdf, Gll^Fdf, Gs^Fds, Gs, Gd, Gs^Fds, Gg^Ve, Gll, Gs, Gs, Gs^Fds, Gg, Gll, Gs^Fds, Gs^Fds, Gs^Fds, Gll^Fdf
Gs^Fds, Gll^Fdf, Gll^Fdf, Gs^Fds, Gll^Fdf, Gll, Gll, Gll, Gs, Gs^Fds, Gg^Fet, Gg^Efm, Gll, Gll^Fdf, Gs, Gs, Gg, Gll, Gll^Fdf, Gs^Fds, Gs^Fds, Gs^Fds
Gs^Fds, Gs^Fds, Gs^Fds, Gll^Fdf, Gs^Fds, Gll^Fdf, Gll^Fdf, Gll^Fdf, Gll^Fdf, Gll^Fdf, Gs^Fds, Gg^Efm, Gll, Gll, Gll, Gll^Fdf, Gll^Fdf, Gll, Gll^Fdf, Gll^Fdf, Gs^Fds, Gs^Fds
Gs^Fds, Gs^Fds, Gs^Fds, Gs^Fds, Gs^Fds, Gs^Fds, Gs^Fds, Gs^Fds, Gs^Fds, Gs^Fds, Gs^Fds, Gs^Fds, Gs^Fds, Gll, Gs^Fds, Gs^Fds, Gs^Fds, Gs^Fds, Gs^Fds, Gs^Fds, Gs^Fds, Gs^Fds
