Rp, Gs^Fds, Gs^Fds, Gs^Fds, Gs^Fds, Gs^Fds, Gs^Fds, Gs^Fds, Gs^Fds, Gg, Cv, Gs^Fds, Gs^Fds, Gg, Gg, Gg, Gs^Fds, Gs^Fds, Gs^Fds, Gg, Gs^Fds, Gs^Fds, Gs^Fds, Gs^Fds, Gs^Fds, Gs^Fds, Gs^Fds, Gs^Fds, Gs^Fds, Gs^Fds, Gs^Fds, Gs^Fds, Gs^Fds, Gs^Fds, Gs^Fds, Gs^Fds, Gs^Fds, Gs^Fds, Gs^Fds, Gs^Fds, Gs^Fds, Gs^Fds, Gs^Eqf, Gs^Eqf, Gs^Fds, Gs^Fds, Gs^Fds, Gs^Fds, Gs^Fds, Hh, Hh, Hh, Hh, Hh, Gs^Fds, Gs^Fds, Gs^Fds, Gs^Fds
Gg^Eff, Gs^Fds, Gs^Fds, Gs^Fds, Gs^Fds, Gs^Fds, Gs^Fds, Gs^Fds, Gg, Gg, Gs^Fds, Gs^Fds, Gs^Fds, Gg, Gg, Gs^Fds, Gs^Fds, Gs^Fds, Gs^Fds, Gs^Fds, Gs^Fds, Gs^Fds, Gg, Gs^Fds, Gs^Fds, Gs^Fds, Gs^Fds, Gs^Fds, Gs^Fds, Gs^Fds, Gs^Fds, Gs^Fds, Gll, Gs^Fds, Gs, Gs^Fds, Gs^Fds, Gs^Fds, Gs^Fds, Gs^Fds, Gs^Eqf, Gs^Eqf, Gll^Fdf, Gs^Fds, Gll^Fdf, Gll^Fdf, Gll^Fdf, Gs^Fds, Gs^Fds, Gs^Fds, Gs^Fds, Hh, Hh, Hh, Hh, Gs^Fds, Gs^Fds, Gs^Fds
Gg^Gvs, Gg^Eff, Gg^Eff, Gs^Fds, Gg, Gs^Fds, Gg, Gg, Gs, Gg, Ww, Ss, Ss, Gg, Gg, Gg^Es, Gs^Fds, Gs^Fds, Gs^Fds, Gs^Fds, Gll, Gg, Gs, Gs, Gg, Gll, Gll, Gs^Fds, Gs^Fds, Gll^Fdf, Gs, Gll, Gg, Gll, Gs^Fds, Gs^Fds, Gs^Fds, Gs^Fds, Gs^Eqf, Gs^Eqf, Gll^Fdf, Gll^Fdf, Gs^Fds, Gll^Fdf, Gs^Fds, Gs^Fds, Gs^Fds, Gs^Fds, Gll^Fdf, Gs^Fds, Gs^Fds, Gs^Fds, Gs^Fds, Hh, Hh, Hh, Hh, Hh
Gg^Gvs, Gg^Gvs, Gg^Gvs, Gg^Eff, Gg^Eff, Gg, Rp, Gg, Gs, Gs, Ww, Wwr, Ss, Gg^Fet, Gg, Gs^Fds, Gs^Fds, Gg, Gg, Gll, Gs^Eqf, Gs^Eqf, Gs^Eqf, Gs, Gs^Fds, Gll, Gs^Fds, Gg, Gg, Gll^Fdf, Gll^Fdf, Gs^Fds, Gs^Fds, Gg, Gs^Fds, Gs^Fds, Gs^Eqf, Gs^Eqf, Gll^Fdf, Gll^Fdf, Gll, Gll, Gll, Gll^Fdf, Gll^Fdf, Gll^Fdf, Hh, Gll^Fdf, Hh, Gll, Gll, Gll^Fdf, Gll^Fdf, Gs^Fds, Gs^Fds, Hh, Hh, Hh
Gg^Gvs, Gg^Gvs, Gg^Gvs, Gg^Gvs, Gg^Eff, Gg^Eff, Gg, Gs, Gg^Efm, Gg, Ss, Ss, Gs^Fds, Ss^Es, Gs^Fds, Gs^Fds, Gs^Fds, Gs^Fds, Gs^Eqf, Gs^Eqf, Gll^Fdf, Gll^Fdf, Gll^Fdf, Gs^Eqf, Gs^Eqf, Rb, Gs^Fds, Gs^Fds, Gs^Fds, Gll, Gll, Gs^Fds, Gs^Fds, Gs^Fds, Gs^Eqf, Gs^Eqf, Gs^Fds, Gs^Fds, Gll, Gll^Fdf, Gs^Fds, Gg^Fet, Gll^Fdf, Gs^Fds, Gs^Fds, Gs^Fds, Hh, Hh, Gs^Fds, Gs^Fds, Gs^Fds, Gll, Gll, Gs^Fds, Hh, Hh, Hh, Hh
Gg^Eff, Gg^Gvs, Gg^Eff, Gg^Eff, Gs^Fds, Gg, Gs^Fds, Gg, Gg^Efm, Gg, Gs^Fds, Gs^Fds, Gs^Fds, Gs^Fds, Gg, Gs^Fds, Cv, Gs^Eqf, Gs^Fds, Gs^Fds, Gs^Fds, Gll^Fdf, Gs^Fds, Gs^Fds, Gs^Fds, Gs^Eqf, Gs^Eqf, Gs^Fds, Gs^Fds, Gs^Fds, Gs^Fds, Gs^Fds, Gs^Eqf, Gs^Eqf, Gs^Fds, Gs^Fds, Gs^Fds, Gs^Fds, Gll^Fdf, Gll, Gs^Fds, Gg^Efm, Gg^Efm, Gll^Fdf, Gs^Fds, Gs^Fds, Hh, Gs^Fds, Hh, Gs^Fds, Gll, Gs^Fds, Gll, Gll, Hh, Hh, Gs^Fds, Hh
Gs^Eqf, Gg^Eff, Gs^Fds, Gs^Fds, Gs^Fds, Gs^Fds, Gs^Fds, Gg, Gg^Efm, Gs^Fds, Gg, Gg, Gs^Fds, Gs^Fds, 1 Gg, 2 Gg, Gs^Fds, Gs^Fds, Gs^Fds, Rb, Gs^Fds, Gs^Fds, Gs^Fds, Gs^Fds, Gs^Fds, Gs^Fds, Gs^Fds, Gs^Eqf, Gs^Eqf, Gs^Fds, Gs^Eqf, Gs^Eqf, Gs^Fds, Gs^Fds, Gs^Fds, Gs^Fds, Cv, Gll^Fdf, Gs^Fds, Gs^Fds, Gs^Fds, Gs, Gs, Gg^Efm, Gg, Gs^Fds, Gs, Hh^Vhh, Gg^Efm, Gs^Fds, Gg, Gll, Gll^Fdf, Hh, Hh^Vhh, Hh, Gs^Fds, Gs^Fds
Gs, Gs^Eqf, Gs^Eqf, Gs^Fds, Gs^Fds, Gs^Fds, Gs^Fds, Gs^Fds, Gg, Gg^Efm, Gs^Fds, Gs^Fds, Gs^Eqf, Cv, Gg, Gs^Fds, Gg, Gs^Fds, Rb, Gs^Fds, Gs^Fds, Gs^Fds, Gs^Fds, Gs^Fds, Gs^Fds, Gs^Fds, Gs^Fds, Gs^Fds, Gs^Fds, Gs^Eqf, Gs^Fds, Gs^Fds, Gs^Fds, Gs^Fds, Gs^Fds, Gs^Fds, Kv, Cv, Re, Re, Re, Gll^Fdf, Re, Gd, Gd, Re, Gs^Edb, Re, Gg, Gg, Gll^Fdf, Gll^Fdf, Gg, Hh, Hh, Gs^Fds, Gs^Fds, Gs^Fds
Rp, Gs^Fds, Gg, Gs^Eqf, Gs^Eqf, Gs^Fds, Gs^Fds, Gs^Fds, Gs^Fds, Gg, Gs^Eqf, Gs^Eqf, Gs^Fds, Gs^Fds, Gs^Fds, Gg^Ve, Gg, Gg, Gs^Fds, Gs^Fds, Gs^Fds, Gs^Fds, Gs^Fds, Gs^Fds, Gs^Fds, Gs^Fds, Gll, Gll, Gll, Gs^Fds, Gll, Gs^Fds, Gll, Gs^Fds, Gs^Fds, Re, Re, Re, Re, Re, Gs^Fds, Re, Re, Re^Edb, Gs, Gs, Gd, Re, Gd, Gd^Edt, Gs, Gs, Gs^Fds, Gll^Fdf, Gs^Fds, Gs^Fds, Gs^Fds, Gs^Fds
Rp, Gg, Gs^Fds, Gs^Fds, Gs^Fds, Gs^Eqf, Gs^Eqf, Gs^Fds, Gs^Eqf, Gs^Eqf, Gg, Gg, Gs^Fds, Gs^Fds, Gs^Fds, Gg, Gs^Fds, Gs^Fds, Gs^Fds, Gll^Fdf, Gs^Fds, Gs^Fds, Gs^Fds, Gs^Fds, Gg, Gll, Gg^Fet, Gll, Gs^Fds, Gll, Gs^Fds, Gll, Gs^Fds, Gs^Fds, Gg, Re, Re, Re, Gs^Fds, Gs^Fds, Gs^Fds, Gs^Fds, Gll^Fdf, Gg, Gs, Rb, Re, Gg^Ve, Re, Gg^Edt, Gg, Gs^Fds, Gll^Fdf, Gll^Fdf, Gs^Fds, Gs^Fds, Gs^Fds, Gs^Fds
Gs^Fds, Gs^Fds, Gs^Fds, Gs^Fds, Gs^Fds, Gs^Fds, Gs^Fds, Gs^Eqf, Gs^Fds, Gs^Fds, Gg^Efm, Gs^Fds, Gs^Fds, Gs^Fds, Gs^Fds, Gs^Fds, Gll, Gll, Gll, Gll, Gll, Gs^Fds, Gs^Fds, Gs^Fds, Gg, Gg^Efm, Gg, Gg, Gs^Fds, Gs^Fds, Gs^Fds, Gs^Fds, Gs^Fds, Gs^Fds, Gg, Gs^Fds, Kv, Cv, Gll, Gg^Efm, Gs, Gs, Gs, Gs, Gs^Edb, Rd, Rd, Gd, Rb, Gg^Efm, Gll^Fdf, Gg, Gg, Gll, Gll, Gs^Fds, Gs^Fds, Gs^Fds
Gs^Fds, Gs^Fds, Gs^Fds, Gs^Fds, Gs^Fds, Gs^Fds, Gll, Gll, Gg, Gg^Efm, Gg, Gs^Fds, Gg, Gs^Fds, Gg, Gll, Gs^Fds, Gs^Fds, Gs^Fds, Gs^Fds, Gg^Efm, Gg^Efm, Gs^Fds, Gg, Gg^Efm, Gg^Efm, Gg^Efm, Gs^Fds, Gg, Gs^Fds, Gg, Gs^Fds, Gg, Gg, Gg, Gs^Fds, Cv, Cv, Gll, Gll, Gll^Fdf, Gs^Fds, Gs^Fds, Gll^Fdf, Gd, Gd^Edt, Gg^Ve, Gs, Rb, Rb, Gs^Fds, Gs^Fds, Gll, Gg^Efm, Gs^Fds, Gll^Fdf, Gs^Fds, Gs^Fds
Gs^Fds, Gs^Fds, Gs^Fds, Gs^Fds, Gg, Gg, Gll, Gll, Gg^Ve, Gg^Efm, Gg, Gg, Gs^Fds, Gg, Gll^Fdf, Gg, Gg, Gs^Fds, Gs^Fds, Gg, Gg, Gg^Efm, Gll, Gll, Gs^Fds, Gs^Fds, Gs^Fds, Gg, Gs^Fds, Gll, Gll, Gll, Gll, Gll, Gll, Gs^Fds, Gll^Fdf, Gll^Fdf, Gs^Fds, Gll, Gll, Gll^Fdf, Gll, Gs, Gs^Fds, Gs^Fds, Gg^Efm, Gll, Gll^Fdf, Gs, Gs, Gg^Edb, Gll, Gs^Fds, Gs^Fds, Gs^Fds, Gs^Fds, Gs^Fds
Cv, Gs^Fds, Gll, Gll, Gll, Gs^Fds, Gll, Gs^Fds, Gs^Fds, Gg, Gs^Fds, Gg, Gg, Gs^Fds, Gs^Fds, Gll^Fdf, Gs^Fds, Gs^Fds, Gll, Gs^Fds, Gll, Gll, Gll, Gs^Fds, Gll^Fdf, Gll^Fdf, Gll^Fdf, Gll^Fdf, Gll^Fdf, Gs^Fds, Gs^Fds, Gs^Fds, Gs^Fds, Gll, Gll, Gs^Fds, Gs^Fds, Gll^Fdf, Gll^Fdf, Gll^Fdf, Gll^Fdf, Gll, Gll^Fdf, Gs, Gll^Fdf, Gg^Fet, Rd, Gll, Gll, Gs, Gll^Fdf, Gg^Edt, Gll, Gll^Fdf, Gll^Fdf, Gs^Fds, Gs^Fds, Gs^Fds
Ww, Gg^Efm, Gg^Efm, Gs^Fds, Gs^Fds, Gs^Fds, Gs^Fds, Gll, Gg^Ve, Gs^Fds, Gs^Fds, Gll, Rb, Gll, Gs^Fds, Gll^Fdf, Gg, Gs^Fds, Gg, Gll, Gll, Gs^Fds, Gs^Fds, Gs^Fds, Gs^Fds, Gll^Fdf, Gs^Fds, Gs^Fds, Gs^Fds, Gs^Fds, Gll, Gs^Fds, Gs^Fds, Gll, Gs^Fds, Gs^Fds, Gs^Fds, Gs^Fds, Gs^Fds, Gs^Fds, Gs^Fds, Gll^Fdf, Gs^Fds, Gll^Fdf, Gll^Fdf, Gs^Fds, Gs^Fds, Re, Re, Gll, Gs^Fds, Gll^Fdf, Gs^Fds, Gll^Fdf, Gs^Fds, Gs^Fds, Gs^Fds, Gs^Fds
Wo, Ww, Wo, Cv, Gll, Gll, Gs^Fds, Gs^Fds, Gs^Fds, Gs^Fds, Gll^Fdf, Gs^Fds, Gs^Fds, Gg, Gg, Gs^Fds, Gll, Gs^Fds, Gg, Gll^Efm, Gg^Efm, Gll, Gg, Gll, Gg, Gs^Fds, Wo, Gs^Fds, Wo, Gg, Wo, Gs^Fds, Wo, Gll, Gll, Gs^Fds, Gs^Fds, Gs^Fds, Hh, Gs^Fds, Hh, Gs^Fds, Hh, Gs^Fds, Gll^Fdf, Gs^Fds, Gg, Gs^Fds, Re, Gs^Fds, Gg, Gs^Fds, Gs^Fds, Gs^Fds, Gll^Fdf, Gs^Fds, Gg, Gs^Fds
Ss, Wo, Wo, Ww, Gg^Edb, Gll, Cv, Gs^Fds, Gs^Fds, Gs^Fds, Gll, Gll^Fdf, Gll^Fdf, Gg^Efm, Gg, Gs^Fds, Gll, Gs^Fds, Gg, Gg, Ww, Gg^Efm, Ww, Gg, Wo, Wo, Ww, Wo, Ww, Wo, Ww, Wo, Wo, Wo, Wo^Bw/, Gll, Gll, Gs^Fds, Hh, Hh, Hh, Hh, Hh, Hh, Gll^Fdf, Gg, Gll, Gg^Edb, Rb, Rd, Gg, Gg, Gg, Gs^Fds, Gs^Fds, Gs^Fds, Gs^Fds, Gs^Fds
Ss, Ss, Wo, Ww, Wo, Ww, Gg^Edb, Gg, Gg, Gs^Fds, Gs^Fds, Gll, Gll, Gs^Fds, Gs^Fds, Gll, Gll, Gs^Fds, Gg, Wo, Wo, Ww, Wo, Wo, Ww, Ww, Gll, Ww, Gg, Ww, Gg, Ww, Ww^Bw/, Wo^Bw/, Wwr, Wo, Wo, Hh, Hh, Hh, Hh, Hh, Gll^Fdf, Gs, Gg^Ve, Gll, Gg, Gll, Rb, Rd, Gg^Ve, Gll, Gll, Gs^Fds, Gs^Fds, Gll^Fdf, Gs^Fds, Gg
Gll^Fdw, Ss, Ss, Wo, Ss, Wo, Wo, Ww, Ww, Cv, Gs^Fds, Gs^Fds, Cv, Gll, Gll, Gll, Gg, Gg, Wwr, Wwr^Bw\, Wo^Bw\, Wo, Ww, Wo, Re, Re, Rb^Efs, Gd, Re, Gg, Gs, Gg, Gg, Ww, Wo, Wo, Gg, Gs^Fds, Hh, Hh, Hh, Hh, Hh, Gg, Gll, Gll^Edb, Rb, Re, Rb, Gd, Gg^Efm, Gll, Gg^Edb, Gs^Fds, Gs^Fds, Gs^Fds, Gll^Fdf, Gs^Fds
Wo, Wo, Ss, Ss, Wo, Wo, Ss, Wo, Wo, Ww, Ww, Gs^Fds, Wo, Gs^Fds, Ww, Cv, Ww, Ww, Wo, Wo, Gs, Gs, Gd, Gs, Ias^Efs, Ias^Efs, Ias, Rb^Efs, Ias^Efs, Re, Gg^Fet, Gs, Gg, Ww, Wo, Wo, Gs^Fds, Gll, Hh, Hh, Hh, Gg, Gs, Hh, Gg^Efm, Gg^Edb, Gd, Gll, Rb, Rb, Gs^Edt, Gg^Edb, Gll, Gs^Fds, Gs^Fds, Gs^Fds, Gll^Fdf, Gs^Fds
Wo, Gll^Fdw, Gll^Fdw, Ss, Ss, Wo, Wo, Wo, Ss, Wo, Wo, Ww, Wo, Ww, Ww, Ww, Ww, Ww, Wo, Wo, Cv, Gs, Gg^Fet, Gg, Rb^Efs, Rb, Ias, Ias, Ias^Efs, Re, Gs, Gs, Gg, Ww, Wo, Wo, Gs^Fds, Gs^Fds, Hh, Hh, Hh, Gg, Gs, Gs^Fds, Gs^Fds, Rb, Re, Rd, Rd, Rb, Gg^Ve, Gg, Gg, Gs, Gs^Fds, Gg, Gs^Fds, Gs^Fds
Ss, Ss, Gd^Fetd, Ss, Ss, Ss, Ss, 3 Ss^Vhs, Ss, Ss, Wo, Wo, Wo, Wo, Wo, Wo, Wo, Ww, Wo, Wo, Ss, Gg, Gg, Gs, Gg, Rb^Efs, Rb^Efs, Ias^Efs, Gg, Gs, Gg, Gs, Wo, Ww, Wo, Gg, Gll, Gs^Fds, Hh, Gll^Fdf, Gg, Gg, Gg^Ve, Gs, Gs^Fds, Gg, Gg, Re, Gg, Gll, Gg, Gg, Gs, Gg, Gg^Fet, Gs^Fds, Gs^Fds, Gs^Fds
Ss, Wo, Wo, Gll^Fdw, Gll^Fdw, Gll^Feth, Ss, Ss, Wo, Ss, Ss, Ss, Ss, Ss, Ss, Wo, Ss, Wo, Wo, Wo, Ww, Ss, Ww, Cv, Ss, Gg, Ss, Gg, Wo, Cv, Ww, Wo, Wo, Wo, Gs^Fds, Gg, Gs^Fds, Gs^Fds, Gll^Fdf, Gll^Fdf, Gs^Fds, Gs^Fds, Gs^Fds, Gg, Gs^Fds, Gs^Fds, Gs^Fds, Gg, Gs, Gs, Gs^Fds, Gll^Fdf, Gs^Fds, Gg, Gs^Fds, Gs^Fds, Gs^Fds, Gs^Fds
Wo, Wo, Ss, Wo, Wo, Ss, Wo, Wo, Wo, Wo, Wo, Wo, Wo, Wo, Ss, Ss, Ss, Wo, Wo, Wo, Wo, Ww, Wo, Ww, Wo, Ss, Wo, Wo, Wo, Ww, Wo, Wo, Gg, Gll, Gs^Fds, Gs^Fds, Gs^Fds, Gs^Fds, Gg, Gs^Fds, Gll^Fdf, Gll^Fdf, Gll^Fdf, Gs^Fds, Gg, Gs^Fds, Gg, Gs^Fds, Gll^Fdf, Gll^Fdf, Gg, Gs^Fds, Gg, Gs^Fds, Gg, Gs^Fds, Gg, Gs^Fds
