Hd, Md, Md, Md, Md, Md, Md, Md^Xm, Md, Md, Md, Md, Md^Xm, Md^Xm, Md, Md, Md, Rd, Hd, Hd, Hd, Hd, Hd, Dd, Dd, Dd, Dd, Dd, Dd^Do, Dd, Dd, Dd, Dd, Dd, Dd, Dd, Dd, Dd, Dd^Dc, Dd, Dd, Dd
Wwrg, Hd, Hd, Hd, Hd, Hd, Hd, Md, Hd, Md^Xm, Md, Md^Xm, Md, Md, Md, Md, Hd, Hd, Hd, Hd, Dd, Dd, Dd, Dd, Rd, Dd, Dd, Dd, Dd, Dd, Dd, Dd, Dd, Dd, Dd, Rd, Rd, Dd, Rd, Dd, Dd, Dd
Wwf, Dd^Edp, Dd, Rd, Wwrg, Dd, Dd^Edp, Hd, Dd, Hd, Hd, Md, Hd, Hd, Dd^Edpp, Hd, Hd, Hd, Dd, Dd, Rd, Dd, Rd, Dd, Rd, Dd, Dd, Dd, Dd, Dd, Dd, Dd^Edpp, Dd, Dd, Dd, Dd, Dd, Rd, Dd^Esd, Rd, Rd, Dd
Rd, Wwf, Wwf, Dd, Dd, Wwf, Wwrg, Wwf, Wwf, Dd, Dd, Hd, Dd^Dc, Hd, Hd, Hd, Dd, Dd, Rd, Rd, Rd, Rd, Rd, Rd, Rd, Dd, Dd, Dd, Dd, Dd, Dd, Rd, Dd, Dd, Dd, Dd, Dd, Dd, Dd, Dd, Dd, Dd
Dd, Dd, Dd, Dd, Dd, Dd, Rd, Dd^Edp, Dd, Wwf, Dd, Dd, Dd, Dd, Dd, Dd, Rd, Rd, Dd, Dd, Dd, Dd, Dd, Dd^Edpp, Dd, Rd, Dd, Dd^Esd, Dd, Dd, Dd, Mdd, Mdd^Xm, Dd, Dd^Edpp, Dd, Dd, Dd, Dd, Dd, Dd, Dd
Dd, Dd, Dd, Dd, Dd, Dd, Rd, Dd, Dd, Dd, Rd, Dd, Rd, Dd, Rd, Rd, Rd, Dd, Dd, Dd, Dd, Dd, Dd, Dd, Dd, Rd, Rd, Rd, Rd, Dd, Mdd, Mdd, Mdd^Xm, Mdd^Xm, Mdd, Dd, Dd, Dd, Dd, Dd, Dd, Dd
Dd, Rd, Rd, Rd, Rd, Dd, Dd, Rd, Dd, Dd, Dd, Rd, Dd, Rd, Dd, Wwf, Wwf, Rd, Rd, Dd, Dd, Dd, Dd, Dd, Dd, Dd, Rd, Dd, Dd^Dc, Rd, Rd, Mdd, Mdd, Mdd, Dd^Dr, Mdd, Mdd, Dd, Dd, Rd, Dd, Dd
Dd, Dd, Dd, Dd, Dd, Rd, Dd, Rd, Rd, Dd, Dd, Rd, Rd, Dd, Dd, Dd, Dd, Wwf, Wwf, Dd, Dd, Dd, Rd, Dd, Rd, Rd, Dd, Dd, Mdd, Dd, Rd, Rd, Rd, Dd^Esd, Dd^Esd, Dd^Esd, Mdd, Mdd^Xm, Mdd^Xm, Rd, Rd, Dd
Dd, Dd, Dd, Dd, Dd, Dd, Rd, Dd^Edpp, Dd, Dd, Dd^Vdt, Dd, Rd, Rd, Rd, Dd, Dd, Dd, Dd, Wwrg, Dd^Edp, Dd, Dd, Rd, Rd, Dd, Dd, Dd, Dd, Mdd, Mdd^Xm, Dd, Rd, Rd, Mdd, Rd, Rd, Mdd, Mdd, Dd, Rd, Dd
Dd, Dd, Dd, Dd^Esd, Rd, Rd, Dd, Dd, Dd, Dd, Re, Dd, Rd, Rd, Dd, Dd, Dd, Rd, Rd, Dd, Rd^Edp, Dd, Dd, Dd, Dd, Rd, Rd, Dd, Dd, Mdd, Mdd^Xm, Mdd^Xm, Mdd^Xm, Dd^Esd, Dd^Esd, Mdd, Mdd, Dd^Esd, Dd^Edpp, Mdd, Rd, Rd
Dd, Rd, Rd, Dd, Rd, Dd, Dd, Rd, Rd, Dd, Re, Dd, Re, Dd, Dd, Dd, Dd, Dd, Dd, Rd, Dd, Wwf, Wwf, Dd, Dd, Dd, Rd, Dd, Dd, Mdd, Mdd, Mdd^Xm, Mdd, Mdd, Dd^Esd, Rd, Rd, Mdd, Mdd, Rd, Dd, Dd
Dd, Dd, Dd, Rd, Rd, Dd, Re, Rd, Rd, Dd, Co, Re, Rb, Re, Dd, Dd^Edpp, Dd, Dd, Dd, Dd, Dd^Vdt, Dd^Edp, Wwrg, Dd, Dd, Rd, Rd, Rd, Rd, Dd, Rd, Mdd, Rd, Mdd, Rd, Rd, Dd^Esd, Rd^Esd, Mdd, Dd, Dd, Dd
Re, Dd, Dd, Dd, Dd, Dd, Rd, Dd, Rd, Rd, Rd, Co, Co, Rb, Rb, Dd, Dd, Dd, Rd, Dd, Rd, Dd, Rd, Dd, Rd, Rd, Dd, Dd, Dd, Rd, Dd, Rd, Dd, Rd, Dd, Mdd, Mdd, Dd^Dr, Mdd, Mdd, Mdd, Dd
Dd, Re, Re, Dd, Re, Dd, Rd, Rd, Re, Rd, Re, Gd, Rd, Rd, Rd, Rd, Rd, Rd, Dd, Rd, Dd, Rd, Dd, Rd, Dd, Dd, Dd, Dd, Dd^Edpp, Dd, Dd, Dd, Dd, Dd, Dd^Dc, Dd, Dd, Mdd, Dd, Mdd, Mdd, Dd
Dd, Dd, Rd, Re, Co, Co, Rd, Rd, Re^Vct, Re, Rb, Gd^Vo, Re, Rd, Rb, Re, Co, Re, Dd, Dd^Esd, Dd, Dd, Dd, Dd, Wwrg, Rd, Rd, Dd, Dd, Dd, Dd, Dd, Dd, Dd, Dd, Dd, Dd, Dd, Dd^Esd, Dd, Rd, Rd
Re, Dd, Co, Co, Rb, Rb, Gd, Re, Ur, Rb, Rd, Rd, Rd, Rb^Ecf, Rd, Rd, Co, Re, Re, Dd, Dd, Dd, Dd, Dd, Rd, Wwf, Wwrg, Rd, Rd, Dd, Dd, Dd, Dd, Rd, Rd, Dd, Dd, Dd, Rd, Rd, Dd, Dd
Dd, Re, Rd, Rd, Gd, Gd^Vo, Gd, Ur, Rd, Ur, Ur, Rd, Rb, Rd, Re^Vct, Rd, Co, Rb, Rd, Dd, Dd, Dd, Dd, Dd, Dd, Rd, Wwf, Dd^Edp, Dd, Rd, Dd, Dd, Dd, Rd, Rd, Dd, Dd^Do, Dd, Dd, Dd, Dd, Dd
Dd, Re, Re, Rd, Rb^Ecf, Rd, Rd, Rd, Co, Co, Rb, Co, Ur, Ur, Ur, Ur, Rd, Re, Re, Rd, Rd, Dd, Dd, Dd, Dd, Dd, Dd^Edp, Wwf, Dd, Dd, Dd, Dd, Dd^Esd, Dd, Dd, Rd, Dd, Dd, Rd, Dd, Dd, Dd
Re, Re, Co, Rd, Re, Rd, Gd, Co, Rb, Rb, Re, Co, Rb, Rb, Re^Vct, Rd, Rd, Re, Re, Dd, Dd, Dd, Rd, Rd, Dd, Dd, Dd, Wwf, Dd, Dd, Dd, Dd, Dd, Dd, Dd, Dd, Dd, Dd, Rd, Dd, Dd, Dd
Re, Re, Co, Rd, Re, Gd^Fetd, Gd^Vo, Rb, Co, Re, Re, Co, Re, Re, Rd, Rd, Rd, Dd, Rd, Dd, Dd, Dd^Vdt, Dd, Dd, Dd, Dd, Dd, Dd^Edp, Rd, Dd, Rd, Rd, Dd, Dd, Dd, Rd, Dd, Dd, Dd, Rd, Rd, Dd
Rd, Rb, Co, Rd, Rd, Gd, Rb, Rb, Ur, Co, Co, Re, Re, Re^Vct, Rd, Rd, Co, Dd, Re, Rd, Rd, Dd, Dd, Rd, Dd, Dd, Dd, Rd, Rd, Rd, Dd, Dd, Dd, Dd, Dd, Rd, Dd, Dd, Dd, Dd, Dd, Dd
Rd, Rd, Re, Rd, Co, Rd, Rd, Ur, Rb, Rb, Re, Rb, Rd, Rd, Co, Co, Dd, Re, Dd, Dd, Dd, Dd, Dd, Rd, Rd, Dd, Dd, Dd, Dd, Wwrg, Rd^Edp, Dd, Rd, Dd, Rd, Dd, Dd, Dd, Dd, Dd, Dd, Dd
Re, Re, Dd, Dd, Rb, Co, Co, Ur, Rd, Rb, Re^Vct, Rd, Co, Co, Rb, Rb, Rd, Re, Dd, Rd, Rd, Dd^Esd, Dd, Dd, Dd, Rd, Rd, Dd, Dd, Wwf, Wwf, Rd, Rd, Rd, Dd, Rd, Dd, Dd, Dd, Dd, Rd, Rd
Rd, Dd, Rd, Dd, Dd, Rb, Rb, Co, Rd, Rd, Rd, Rd, Dd, Re, Dd, Dd, Rd, Dd, Dd, Rd, Dd, Dd, Rd, Dd^Edpp, Dd, Dd, Dd, Rd, Dd, Dd, Rd^Edp, Wwrg, Dd, Dd, Dd, Dd, Dd^Edpp, Dd, Dd, Dd, Dd, Dd
Rd, Rd, Dd, Re, Rd, Re, Dd, Dd, Rd, Re, Dd, Dd, Dd, Rd, Rd, Dd, Dd, Rd, Dd, Dd, Dd, Dd, Rd, Rd, Rd, Dd, Dd^Dc, Dd, Dd, Rd, Dd, Wwf, Dd, Dd, Dd, Dd, Dd, Rd, Rd, Dd, Rd, Dd
Dd, Dd^Vdt, Dd, Re, Dd, Rd, Dd, Dd, Dd, Rd, Rd, Dd, Dd, Rd, Rd, Dd, Dd, Dd, Dd, Dd, Dd, Dd, Dd, Dd, Dd, Rd, Rd, Dd, Dd, Dd, Dd, Wwf, Dd, Dd, Dd, Dd, Dd, Dd, Dd, Rd, Rd, Dd
