Gg, Gg, Gg, Gg, Gg, Gg, Gg, Gg, Gg, Gg, Gg, Gg, Gg, Gg, Gg, Gg, Gg, Gg, Gg, Wo, Wo, Gg, Gg, Gg, Gg, Gg, Gg, Rp, Rp, Gg, Gg, Gg, Gg, Gg, Gg, Gg, Gg, Gg, Gg, Gg, Gg, Gg, Gg, Gg, Gg, Gg, Gg, Gg, Gg, Gg
Gg, Gg, Gg, Gg, Gg, Gg, Gg, Gg, Gg, Gg, Gg, Gg, Gg, Gg, Gg, Gg, Gg, Gg, Gg, Wo, Wo, Wo, Ww, Gg, Gg, Gg, Rp, Rp, Gg, Gg, Gg, Gg, Gg, Gg, Gg, Gg, Gg, Gg, Gs, Gg, Gg, Gg, Re, Gs, Ce, Gg, Gg, Gg, Gg, Gg
Gg, Gg, Gg, Gg, Gg, Gg, Gg, Gg, Gg, Gg, Gg^Efm, Gg, Gg, Gg, Co, Co, Ko, Gg, Gg, Ww, Ww, Ww, Ww, Wwf, Rp, Rp, Rp, Rp, Rp, Gg, Gg, Gg, Gg, Gg, Gg, Gg, Gg, Gg, Gg, Re^Vct, Gs, Gs, Ce, Ce, 1 Ke, Ce, Re, Gg, Gg, Gg
Gg, Gg, Gg, Gg, Gg, Gg^Efm, Gg, Gg, Gs, Gs, Gg^Efm, Gg, Gg, Gg, Co, Co, Gg, Gg, Gg, Gg, Gg, Ww, Ww^Bsb/, Wo^Bsb/, Wwf, Gg, Re^Vct, Gg, Gg, Rp, Gg, Gg, Gs, Gg, Gg, Gg, Gg, Gg, Gg, Gs, Gs, Re, Re, Ce, Ce, Re, Gg, Gg, Gg, Gg
Gg, Gg, Gg, Gg, Gg, Gg, Gg, Gg, Gs, Gg, Gg, Gg, Gg, Gg, Co, Co, Gg, Gg, Gg, Gs, Re^Vct, Rr, Rr, Wwr, Wwr, Gg, Gg, Gg, Gg, Gg, Gg, Gs, Re^Vct, Gs, Gg, Gg, Gg, Gg, Gg, Gg, Re^Vct, Gs, Re, Ce, Re, Re, Gg, Gg, Gg, Gg
Gg, Gg, Gg, Gg, Gg, Gg, Gg, Gg, Gg, Gs, Gs, Gg, Gg, Gg, Rr, Gg, Gg, Gg, Gg, Gs, Rr, Rr, Wo, Wo^Bsb\, Wo^Bsb\, Gg, Gg, Gg, Gg, Gg, Gs, Gs, Gg, Gs, Gg, Gg, Gg, Gg, Gg, Gg, Gs, Gg, Rb, Re, Gg, Re, Re^Vct, Gg, Gg, Gg
Gg, Gg, Gg, Gg, Gg, Gg, Gg, Gg, Gg, Gs, Gs, Gs, Gg, Gg, Gg, Rr, Gg, Gg, Rr, Rr, Rr, Ww, Wo, Ww, Gg, Rp, Rp, Gg, Gg, Gs, Gs, Gg, Gg, Gs, Gg, Gg, Gg, Gg, Gg, Gg, Gs^Fds, Gg, Gs^Fds, Gg, Gg, Gs, Gs, Gs, Gg, Gg
Gg, Gg, Gg, Gg, Co, Co, Gg, Gg, Gg, Gg, Gg, Gg, Gg, Gg, Gg, Rr, Rr, Rr, Gg, Gs, Gg, Ww, Wo, Ww, Gg^Eff, Gg^Efm, Rp, Rp, Rp, Gs, Gg, Gg, Gg, Gg, Gg, Gg, Gg, Gg, Gg, Gg, Gs^Fds, Gs^Fds, Gs^Fds, Gs^Fds, Gs^Fds, Gg, Gg, Gs, Gg, Gg
Gg, Gg, Gg, Gg, Co, Co, Co, Ko, Gg, Gg, Gs, Gg, Gg, Gg, Gg, Gg, Rr, Rr, Gg, Gg, Gg, Wo, Wo, Ww, Gg^Gvs, Gg^Eff, Gg, Rp, Gg, Gg, Gs^Fds, Gs^Fds, Gs^Fds, Gg, Gg, Gg, Gg, Gg, Gg, Gg, Gg, Gs^Fds, Gg, Gs^Fds, Gg, Gg, Gg, Gg, Gg, Gg
Gg, Gg, Gg, Gg, Rr, Co, Co, Co, Gg, Gg, Gs, Gg, Re^Vct, Gs, Gs, Gg, Gg, Rr, Gg, Gs, Gg, Wo, Wo, Ww, Gg^Gvs, Gg^Gvs, Gg^Gvs, Gg, Gg^Eff, Gs^Fds, Gs^Fds, Gs^Fds, Gs^Fds, Gs^Fds, Gs^Fds, Gg, Gg, Gg, Gs, Gg, Gs, Gg, Gg, Gg, Gg, Gg, Gg, Gg, Gg, Gg
Gg, Gg, Gg, Gg, Gg, Rr, Rr, Gg, Gg, Gg, Gg, Gs, Gs, Gg, Gs, Gs, Gg, Rr, Gg, Gg, Gs, Ww, Wo, Wo, Ww, Gg^Gvs, Gg^Gvs, Gg^Gvs, Gg^Eff, Gs^Eff, Gs, Gg, Gs, Gs^Fds, Rb, Gg, Gg, Gg, Gg, Gs, Gs, Gs, Re^Vct, Gg, Gg, Gg, Gg, Gg, Gs^Fds, Gs^Fds
Gg, Gg, Gg, Gg, Gg, Gg, Rr, Gg, Gg, Gg, Gg, Gg, Gg, Gs, Rr, Gs, Rr, Rr, Gg, Gg, Gg, Gs, Gs, Wo, Ww, Wwr, Wwf, Gg^Eff, Gg^Gvs, Re^Wm, Gs, Gs, Gs, Rb, Rb, Gg, Gg, Rb, Rb, Gg, Gg, Gs, Gs, Gs, Gg, Gg, Gs^Fds, Gs^Fds, Gs^Fds, Gs^Fds
Gg, Gg, Gg, Gg, Gg, Gg, Rr, Gg, Gg, Gg, Gg, Gg, Rr, Rr, Rr, Rr, Gg, Rr, Rr, Gg, Gs, Re^Vct, Gg, Wo, Wo, Ww, Ww, Ww, Ww, Gg, Gs, Gs, Gg, Gg, Rb, Rb, Rb, Gg, Gg, Gg, Gg, Gg, Gg, Gg, Gg, Gg, Gs^Fds, Gs^Fds, Gs^Fds, Gs^Fds
Gg, Gg, Gg, Gg, Gg, Gg, Rr, Rr, Gg, Gg, Rr, Rr, Gg, Gg, Gg, Gg, Gg, Gg, Rr, Gs, Gg, Gs, Gg, Wo, Wo, Ww, Wo, Ww, Ww, Ww, Ww^Em, Gg, Rb, Rb, Gg, Rb, Gg, Gg, Gs^Fds, Gs^Fds, Gs^Fds, Gs^Fds, Gs^Fds, Gg, Gg^Wm, Gg, Gs^Fds, Gs^Fds, Gg^Eff, Gs^Fds
Gg, Gg, Gg, Gs, Gg, Gg, Rr, Rr, Rr, Rr, Gg, Gg, Gg, Gg, Gg, Gg, Gs, Gg, Gg, Rr, Rr, Gg, Ww, Ww, Wo, Wo, Wo, Wo, Ww^Ewf, Ww, Wo^Bw/r, Ww^Bw/r, Ww^Ewl, Gg, Gg, Gg, Gg, Gg, Gg, Gs^Fds, Gs^Fds, Gs^Fds, Gs^Fds, Gg, Gg, Gg, Gg^Eff, Gg^Eff, Gg^Gvs, Gg^Gvs
Gg, Gg, Gg, Gs, Gg, Gg, Gg, Rr, Gg, Gg, Gg, Gg, Gg, Gg, Co, Gg, Gg, Gs, Gs, Gg, Rr, Rr, Ww^Ewl, Ww, Wo, Wo, Ww, Wo, Ss^Bw/r, Wo^Bw/r, Wo, Wo, Ww, Gg, Wwr, Gg, Gg, Gg, Re^Vct, Gg, Gs, Gg, Gg, Gg, Rp, Rp, Gg^Eff, Gg^Eff, Gg^Gvs, Gg^Gvs
Gg, Gg, Gg, Gs, Gg, Gg, Gg, Rr, Gg, Gg, Gg, Gg, Rr, Co, Ko, Co, Co, Gs, Gs, Gs, Gg, Rr, Gg, Ww, Wo, Ww^Ewl, Ss^Vhs, Ss^Bw/r, Ss^Vhs, Ss, Ss^Em, Wo, Wo, Ww, Ww, Gg, Gg, Gg, Gs, Gs, Rp, Gg, Rp, Rp, Gg^Eff, Gg^Eff, Gg^Gvs, Gg^Gvs, Gg^Gvs, Gg^Gvs
Gg, Gg, Gg, Gg, Gs, Gg, Gg, Rr, Rr, Gg, Gg, Gg, Rr, Co, Co, Co, Gg, Gg, Gg, Gs, Gg, Gg, Wwr, Ww, Wo, Ss^Em, Ss^Bw/r, Ss^Bw|r, Ss^Bw\r, Ss^Em, Ss^Em, Wo, Wo, Wo, Ww, Ww, Gg, Gs, Gg, Gs, Rp, Rp, Rp, Gg^Eff, Gg^Eff, Gg^Gvs, Gg^Gvs, Gg^Gvs, Gg^Gvs, Gg^Gvs
Gg, Gg, Gg, Gg, Gg, Gg, Gg, Gg, Gg, Rr, Gg, Gg, Rr, Rr, Gg, Gg, Gg, Gg, Gg, Gg, Gg, Gg, Ww, Ww, Wot^Bw/r, Wo^Bw/r, Wo, Ss^Em, Wo, Wo^Bw\r, Wo^Bw\r, Wo, Ww, Ww, Wwr, Wwf, Wwf, Gg, Gg, Gg, Rp, Gg, Gg, Rp, Ww, Wwf, Ww, Gg^Gvs, Wo, Gg^Gvs
Gg, Gg, Gs, Gs, Gs, Gs, Gs, Gs, Gs, Rr, Rr, Rr, Rr, Gg, Gg, Gg, Gg, Gg, Gg, Gg, Gg, Gg, Rb, Ww^Bw/r, Ww, Ww, Ww, Wo, Ww, Ww^Ewf, Ww^Bw|r, Wwr, Gg, Gg, Gg, Wwf, Wo, Wo, Wo^Bsb/, Wo^Bsb/, Wwr, Wwr, Wo^Bsb/, Rp, Wo, Ww, Ww, Wo, Ww, Wo
Gg, Gg, Gs, Gs, Re^Vct, Gg, Gg, Gg, Gg, Gg, Rr, Rr, Gg, Gg, Gs, Gg, Gs, Gg, Gg, Gg, Gg, Rr, Gg, Gg, Gg, Wwr, Gg, Ww, Gg, Ww^Em, Rb, Gg, Gs, Gs, Gg, Gg, Rr, Wo^Bsb/, Wwr, Wwr, Ww^Bsb/, Ww^Bsb/, Wwr, Wo, Gs, Gg, Gs, Wwr, Gg, Ww
Gg, Gg, Gs, Gs, Gs, Gs, Gg, Gg, Gg, Gg, Rr, Rr, Gs, Gs, Gg, Gs, Gg, Gg, Gg, Gg, Rr, Rr, Gg, Gg, Gg, Gg, Gg, Gg, Gs, Rb, Gs, Gs, Re^Vct, Gs, Gs, Gg, Rr, Gd^Ebn, Rr, Rr, Gg, Gg, Gg, Gs, Gg, Gs, Gs, Gg, Gg, Gg
Gg, Gg, Gg, Gg, Gg, Gg, Gg, Gg, Gg, Gg, Rr, Rr, Gs, Gg, Re^Vct, Gs, Gg, Gg, Gg, Rr, Rr, Gg, Gg, Gg, Gg, Gg, Gg, Gg, Gg, Rb, Gg, Gs, Gs, Gs, Rr, Rr, Rr, Rr, Rr, Rr, Gs^Fds, Gs^Fds, Gg, Gs, Gg, Re^Vct, Gs, Gg, Gg, Gg
Gg, Gg, Gg, Gg, Gg, Gg, Gg, Gg, Gg, Gg, Rr, Rr, Gg, Gs, Gs, Gs, Gg, Gg, Gg, Rr, Rr, Gg, Gg, Gg, Co, Co, Gg, Gg, Gg, Gg, Gg, Gg, Gg, Gs, Rr, Rr, Gg, Rr, Gs^Fds, Gs^Fds, Gs^Fds, Gs^Fds, Gg, Gs, Gs, Gs, Gg, Gg, Gs^Fds, Gg
Gg, Gg, Gg, Gg, Gg, Gg^Ecf, Gg, Gg, Gg, Gg, Rr, Rr, Gg, Gg, Gg, Gg, Gg, Gg, Gg, Gg, Rr, Gg, Gg, Co, Co, Co, Co, Gg, Gs^Fds, Gs^Fds, Gs^Fds, Gg, Rr, Rr, Gg, Gg, Gg, Gg, Gs, Gs^Fds, Gs^Fds, Gs^Fds, Gs^Fds, Gg, Gg, Gg, Gs^Fds, Gs^Fds, Gs^Fds, Gg
Gg, Gg, Ko, Gg, Gg, Gg, Gg, Gg, Ko, Rr, Rr, Rr, Gg, Gg, Gg, Gg, Gg, Gg, Gg, Gg, Gg, Rr, Rr, Rr, Rr, Co, Co, Gg, Gs^Fds, Gs^Fds, Rr, Rr, Gg, Gg, Gs, Gg, Gs, Gs, Gg, Gg, Gs^Fds, Gs^Fds, Gs^Fds, Gg, Gs^Fds, Gg, Gs^Fds, Gg, Gg, Gg
Ce, Ce, Re, Co, Ko, Gg, Ce, Co, Re, Re, Re, Rr, Rr, Gg, Gg, Gg, Gg, Gg, Gg^Ecf, Gg, Rr, Rr, Rr, Rr, Gg, Ko, Gg, Gg, Gs^Fds, Gs^Fds, Gg, Gg, Gs, Gs, Re^Vct, Gs, Gg, Gg, Gs^Fds, Gs^Fds, Gg, Gg, Gg, Gg, Gs^Fds, Gs^Fds, Gs^Fds, Gg, Gg, Gg
Re, Re, Gd, Re, Re, Ce, Re, Re, Rb, Rb, Gd^Vo, Re, Re, Ko, Ce, Gg, Rr, Gg, Rr, Rr, Rr, Rr, Gg, Gg, Gg, Gg, Gg, Gg, Gg, Rr, Rr, Gg, Gs, Gs, Gg, Gg, Gg, Gg, Gs^Fds, Gs^Fds, Gs^Fds, Gs^Fds, Gg, Gg, Gg, Gs^Fds, Gs^Fds, Gs^Fds, Gs^Fds, Gg
Rb, Rb, Rb, Gd^Vo, Gd, Re, Re, Rb, Gd, Gd, Gd, Gd, Rb, Re, Rr, Rr, Rr, Rr, Rr, Rr, Gg, Gs, Gs, Gs, Gs, Gs, Gg, Gg, Gg, Gg, Gg, Rr, Rr, Gg, Gg, Gg, Gg, Gg, Gs^Fds, Gs^Fds, Gg, Gg, Gg, Gg, Gg, Gg, Gs^Fds, Gs^Fds, Gg, Gg
Re, Rb, Gd, Gd, Re^Ebn, Rb, Gd, Gd^Vo, Re, Re, Rb, Re, Gd, Re, Re, Rr, Co, Rr, Gg, Rr, Rr, Gs, Gg, Re^Vct, Gs, Gg, Gg, Gg, Rr, Rr, Gg, Gg, Gg, Rr, Gg, Gg, Rp, Gg, Gg, Gg, Gg, Gg, Gg, Gg, Gg, Gg, Gg, Gs^Fds, Gs^Fds, Gg
Gd, Gd, Gd^Vo, Gd, Re, 4 Rb, Re, Re, Rb, 5 Rb, Re, Rb, Rb, Gd^Vo, Rb, Re, Re, Ko, Gg, Gg, Gg, Rr, Rr, Gg, Gg, Gg, Rr, Rr, Gg, Gg, Gg, Gg, Gg, Gg, Gg, Rr, Rr, Rp, Gg, Gg, Gg, Gg, Co, Co, Co, Gg, Gg, Gg, Gg, Gs^Fds
Gd, Gd, Gd, Gd, 3 Rb, Rb, Gd^Vo, Gd, Rb, Re, Gd^Vo, Gd, Gd, Rb, Gd, Re, Re, Ce, Gg, Gg, Gg, Rr, Rr, Rr, Rr, Gg, Rr, Gg, Gg, Gg, Co, Co, Co, Co, Gg, Gg, Gg, Rr, Gg, Gg, Gg, Co, Co, Ko, Gg, Co, Gg, Gg, Gg, Gg
Re, Gd, Re, Re, Re, Gd, Re, Gd, 8 Rb, Re, Gd, Gd, Rb, Rb^Ebn, Re, Gd^Vo, Re, Ko, Gg, Gg, Gs, Gs, Gs, Gg, Gg, Rr, Rr, Rr, Rr, Rr, Rr, Co, Co, Co, Gg, Gg, Rr, Rr, Rr, Gg, Rr, Co, Rr, Co, Gg, Gg, Gg, Gg, Gg, Gg
Gd, Re, Re, Gd, Gd^Vo, 2 Re, Gd, Re, Rb, Re, Rb, 6 Rb, Re, Re, Rb, Re, Re, Co, Gg, Gg, Gs, Re^Vct, Gs, Gg, Gs, Gg, Gg, Gg, Rr, Rr, Rr, Ko, Rr, Gg, Rr, Gg, Rr, Rr, Rr, Rr, Rr, Rr, Gg, Gg, Gg, Gg, Gg, Gg, Gg, Gg
Rb, Rb, Re, Gd, Rb, Rb, Gd, Re, 7 Rb, Rb, Gd, Gd, Gd^Vo, Gd, Rb, Re, Re, Ko, Gg, Gg, Gg, Gs, Gg, Gs, Gg, Gs, Gg, Gg, Gg, Rr, Rr, Rr, Rr, Rr, Gg, Rr, Gg, Rr, Gg, Gg, Gg, Gg, Gg, Gg, Gg, Gg, Gg, Gg, Gg, Gg
Rb, Rb, Rb, Rb, Gd, Rb, Gd, Re, Gd, Rb, Gd, Gd, Gd, Re, Re, Rb, Re, Co, Co, Gg, Gg, Gg, Gg, Gg, Gg, Gg, Gg, Gg, Gg, Gg, Gg, Rr, Gg, Gg, Gg, Gg, Gg, Gg, Gg, Gg, Gg, Gg, Gg, Gg, Gg, Gg, Gg, Gg, Gg, Gg
