Gg, Hh, Hh, Hh, Hh, Mm, Mm, Mm, Mm, Mm, Mm^Xm, Mm, Mm, Mm, Mm^Xm, Mm, Mm, Mm, Hh, Hh, Hh, Mm, Mm^Xm, Mm, Mm, Mm, Mm, Mm, Mm^Xm, Mm, Mm^Xm, Mm, Mm, Mm, Hh, Mm, Mm, Mm, Mm, Mm, Mm, Hh, Hh, Hh, Mm^Xm, Gg
Gg, Gg, Gg, Hh, Hh, Hh, Hh, Mm, Hh, Mm, Mm, Mm^Xm, Mm^Xm, Mm, Mm, Mm^Xm, Mm^Xm, Mm, Mm, Hh, Hh, Mm, Mm, Mm^Xm, Mm^Xm, Mm, Mm, Mm, Mm^Xm, Mm^Xm, Mm, Mm, Hh, Hh, Mm, Mm^Xm, Mm, Mm, Mm, Mm, Hh, Hh, Mm^Xm, Mm, Mm, Mm
Gg, Gg, Gg, Gg, Gg, Hh, Hh, Hh, Mm, Mm^Xm, Mm^Xm, Mm, Mm, Mm, Hh^Vhh, Mm, Mm, Mm, Hh, Mm, Hh, Hh, Hh, Mm, Mm, Mm, Mm, Mm, Mm, Mm, Hh, Hh, Mm, Mm^Xm, Mm^Xm, Mm, Mm, Mm^Xm, Mm^Xm, Mm, Hh, Mm, Mm, Mm^Xm, Mm^Xm, Mm
Gg, Gg, Gg, Hh, Hh, Gg, Gg, Hh, Hh, Mm, Mm, Mm^Xm, Mm, Hh^Es, Hh, Hh, Mm, Mm^Xm, Mm, Hh, Mm, Mm^Xm, Mm, Hh, Hh, Hh, Mm, Mm^Xm, Mm^Xm, Mm, Mm, Hh, Hh, Mm, Mm, Mm^Xm, Mm, Mm, Mm, Mm^Xm, Mm, Hh, Hh, Mm, Mm, Mm
Gg, Gg, Re^Vct, Gg, Hh, Hh, Gg, Gg, Gg, Hh, Hh, Mm, Mm, Hh, Mm, Mm^Xm, Mm^Xm, Mm, Hh, Hh, Hh, Mm, Hh, Hh, Gg, Hh, Hh, Mm, Mm, Mm, Hh, Hh, Mm, Hh, Hh, Mm, Mm, Mm^Xm, Mm^Xm, Mm, Hh, Hh, Mm^Xm, Hh, Hh, Mm
Hh, Gg, Gg, Gg^Es, Gg, Hh, Gg, Gg, Gg, Hh, Hh, Hh, Hh, Hh, Hh, Mm, Mm, Mm^Xm, Mm, Hh, Hh, Hh, Gg, Hh, Hh, Gg, Gg, Hh, Hh, Hh, Hh, Hh, Hh, Hh, Mm, Mm^Xm, Mm, Mm, Mm, Mm^Xm, Mm, Mm, Mm, Mm, Hh, Mm
Hh, Hh, Gg, Gg, Gg, Gg, Gg, Gg, Gg, Gg, Gg, Hh, Gg, Hh, Hh, Hh, Hh, Mm, Mm, Mm^Xm, Mm, Hh, Gg, Hh, Hh, Gg, Hh, Hh, Hh, Hh, Gg, Hh, Hh, Hh, Hh, Mm, Hh, Hh, Mm^Xm, Mm, Hh, Hh, Hh, Hh, Hh, Mm
Gg, Hh, Hh, Gg, Gg, Gg, Gg, Hh, Hh, Gg, Gg, Gg, Gg, Gg, Hh, Hh, Hh, Hh, Hh, Mm, Hh, Hh, Gg, Gg, Hh, Hh, Hh, Hh, Hh, Gg, Gg, Gg, Gg, Hh, Hh, Hh, Mm^Xm, Mm^Xm, Mm, Mm, Hh, Hh, Mm, Mm^Xm, Mm, Mm
Gg, Gg, Gg, Gg, Gg, Gg, Gg, Gg, Gg, Hh, Hh, Gg, Gg, Gg, Hh, Hh, Gg, Gg, Gg, Hh, Hh, Hh, Hh, Gs^Fds, Gs^Fds, Hh, Hh, Hh, Hh, Gg, Gg, Gg, Hh, Hh, Mm, Mm^Xm, Mm, Mm, Mm, Hh, Hh, Hh, Hh, Mm, Hh, Hh
Gg, Gg, Gg, Gg, Gg, Gg, Gg, Gg, Gg, Hh, Gg, Gg, Gg, Gg, Hh, Hh, Hh, Hh^Es, Hh, Gg, Hh, Hh, Gg, Gs^Fds, Gs^Fds, Gs^Fds, Gg^Es, Gg, Gg, Hh, Hh, Gg, Hh, Hh, Gs^Fds, Mm, Mm, Mm, Hh, Hh, Hh, Hh, Hh^Vhh, Hh, Hh, Mm
Gg, Gg, Gg, Gs^Fds, Gs^Fds, Gs^Fds, Gll^Fdf, Gg, Gg, Gg, Gg, Gg, Gs, Gg, Gg, Hh, Hh^Es, Hh^Vhh, Hh, Hh, Gg, Gg, Gg, Gs^Fds, Gg, Gs^Fds, Gg, Re^Vct, Gg, Gg^Es, Hh, Hh, Mm, Gs^Fds, Gs^Fds, Gs^Fds, Gg, Hh, Hh, Gg, Hh, Hh, Hh, Hh, Hh, Hh
Gg, Gg, Gs^Fds, Gs^Fds, Gs^Fds, Gll^Fdf, Gll^Fdf, Gg, Gg, Gg, Hh, Ce, Ce, Gs, Gg, Gg, Gg, Hh, Gg, Gg, Gll^Fdf, Gg, Hh, Hh, Hh, Gg, Gg, Gg, Hh, Gg, Mm, Mm^Xm, Mm, Gs^Fds, Gg, Re^Vct, Gg, Gg, Gg, Hh, Hh, Hh, Gg, Hh, Gg, Gg
Gg, Gs^Fds, Gs^Fds, Gs^Fds, Gll^Fdf, Gll^Fdf, Gg, Gg, Gs, Hh, 4 Ke, Hh, Ce, Ce, Gg, Gg, Gg, Gg, Hh, Gll^Fdf, Hh, Gll^Fdf, Gll^Fdf, Gll^Fdf, Hh, Hh, Hh, Hh, Hh, Gg^Efm, Gs^Fds, Mm, Gs^Fds, Hh, Hh, Gg, Hh, Gg, Gg, Gg, Gg, Gg, Gg, Gg, Gg, Gg
Gg, Gg, Gg, Gg, Gg^Es, Re^Vct, Gg, Gs, Ce, Ce, Ce, Ce, Re, Gg, Gg, Gg, Gg, Hh, Hh, Hh, Gg, Gg, Gg, Gg, Gg, Hh, Hh, Hh, Gg, Gg, Gs^Fds, Gs^Fds, Gs^Fds, Gs^Fds, Gg, Hh, Hh, Hh, Hh, Gg, Gg, Gg, Hh, Hh, Gg, Gg
Gg, Gg, Gg, Gg, Gg, Gg^Es, Gg, Gg, Re, Re, Re, Re, Gg, Gg, Gg, Gg, Gg, Gg, Gg, Gs, Gll^Fdf, Gll^Fdf, Gll^Fdf, Gg, Gg, Gg, Hh, Gg, Gg, Gg, Gs^Fds, Gs^Fds, Gg, Gg, Gg, Hh, Hh, Hh, Gs^Fds, Hh, Hh, Gg^Efm, Gs^Fds, Gs^Fds, Gg, Gg
Gg, Gg, Gg, Gg, Gg, Gg, Gg, Gg, Gg, Re, Re, Re, Gg, Gg, Gg, Gg, Gg^Efm, Gg, Gg, Gg, Gs^Fds, Gs^Fds, Gs^Fds, Gs^Fds, Gs^Fds, Gg, Gg, Gg, Gll^Fdf, Gll^Fdf, Gll^Fdf, Gs^Fds, Gs^Fds, Gg, Gg, Gg, Gg, Gs^Fds, Gg, Gg^Efm, Gg, Hh, Gg, Re^Es, Re^Vct, Gg
Gg, Gg, Gll^Fdf, Gll^Fdf, Gll^Fdf, Gll^Fdf, Gg, Gg, Gg, Gg, Re, Re, Re, Gg, Gg, Gg, Gg, Gg^Efm, Gg, Gg, Gg, Gs^Fds, Gg^Es, Re^Vct, Gs, Gg, Gg, Gll^Fdf, Gg, Gll^Fdf, Gg, Gs^Fds, Gs, Gg, Gg, Gg, Gg, Gg, Gg, Gg, Gs, Gg, Gs, Re, Gs, Gs
Gg, Gg, Gll^Fdf, Gll^Fdf, Gg, Gg, Gg, Gg, Gg, Gg, Gg, Rb, Gg, Gg, Gg, Gg, Gg, Gg^Efm, Gg, Gg, Gg, Gg, Gg, Gs, Gs, Gg, Gg, Gg, Gg, Gg, Gg, Gs, Gs, Gs, Hh, Gs^Fds, Gg, Gg, Gg, Gg, Gs, Gs, Gs, Gs, Re, Re
Gg, Gg, Gg, Gg, Re^Vct, Gg, Gg, Gg, Re, Gg, Re, Gg, Gg, Gg, Gg, Gg, Re, Gg, Gg, Gg, Gg, Gg, Hh, Hh, Hh, Gs, Gg, Gg, Gg, Gg, Re^Vct, Gs, Gs, Hh, Hh, Gs^Fds, Gg, Gg, Gg, Gg, Gs, Gs, Gs, Re, Re, Re
Gg, Gg, Gg, Gg^Es, Gg^Es, Gg, Ce, Re, Re^Ecf, Re, Gg, Gg, Gg, Re, Re, Re, Re, Re, Re, Gg, Gg, Gg, Gg, Gll^Fdf, Gll^Fdf, Gs^Fds, Gs^Fds, Gs^Fds, Gg, Gg, Gg, Gg, Gg, Gs, Gg, Gg, Gg, Gg, Gg, Gg, Re, Ce, Ce, Re, Re, Re
Gg, Gg, Gg, Gg, Ce, Ce, Rb, Re, Re, Re, Gg, Gg, Gg, Gg, Gg, Gs, Ce, Re, 2 Ke, Re, Gg, Gg, Gg, Gg, Gll^Fdf, Gs^Fds, Gs^Fds, Gs^Fds, Gg, Gg, Gg, Gg, Gg, Gg, Re^Vct, Gg, Gg^Efm, Gg, Gg, Rb, Re, Ce, Ce, Ce, Re, Gs
Gg, Gg, Gg, Gs, Ce, 3 Ke, Rb, Re, Gg, Gg, Gg^Efm, Gg^Efm, Gg, Gg, Re, Re^Vct, Rb, Ce, Ce, Ce, Gg, Gg^Efm, Gg, Gg, Gll^Fdf, Gs^Fds, Gs^Fds, Gg, Gg, Gg, Gg, Gg, Gg, Gg, Gs, Gg, Gg^Efm, Gg, Gs, Rb, Re, Re^Vct, Ce, 1 Ke, Re^Es, Gs
Gg, Gg, Gg, Ce, Ce, Ce, Gs, Rb, Gg, Gg, Gg, Gg, Gg, Re, Re, Re^Es, Rb, Rb, Gg, Ce, Gg, Gg^Efm, Gg^Efm, Gll^Fdf, Gll^Fdf, Gll^Fdf, Gs, Gg, Gs^Fds, Gs^Fds, Re^Vct, Gg, Gg, Gg, Gs, Gg^Efm, Gg^Efm, Gg, Gg, Gs, Gs, Re, Re^Es, Ce, Ce, Gs
Gg, Gg, Gg, Ce, Gs, Gs, Gg, Gg, Gg, Gg, Gg, Gg, Gg, Gg, Gg, Gg, Gg, Gg, Gg, Gg, Gg^Efm, Gg^Efm, Gg^Efm, Gll^Fdf, Gll^Fdf, Gs, Gs, Gs, Gg^Es, Gs^Fds, Gs^Fds, Gg, Gg, Gg, Gs, Gg, Gg, Gg^Efm, Gg, Gg, Gg, Re, Re, Re, Gg, Gs
Gg, Gg, Gg, Gg, Gg, Gg, Gg, Gg, Gs^Fds, Gs^Fds, Gs^Fds, Gs^Fds, Gll^Fdf, Gll^Fdf, Gg, Gg, Gg, Gg, Gg, Gg^Efm, Gg^Efm, Gg^Efm, Gg, Gg, Gg, Gs, Gs^Fds, Gs^Fds, Gs^Fds, Gs^Fds, Gll^Fdf, Gg, Gg, Gg, Gg, Gg, Gg, Gg^Efm, Gg, Gg, Gg, Gg, Gg, Gg, Gg, Gg
Gg, Gg, Gg, Gg, Gg, Gg, Gg, Gs^Fds, Gll^Fdf, Gll^Fdf, Gs^Fds, Gll^Fdf, Gll^Fdf, Gll^Fdf, Gll^Fdf, Gg, Gg, Gg, Gg, Gg, Gg, Gg, Gg, Gg, Gll^Fdf, Gll^Fdf, Gll^Fdf, Gs^Fds, Gs^Fds, Gs^Fds, Gll^Fdf, Gll^Fdf, Gg, Gg, Gg, Gg, Gg, Gg, Gg, Gg, Gg, Gg, Gg, Gg, Gg, Gg
