Xu, Xu, Xu, Xu, Xu, Xu, Xu, Xu, Xu, Xu, Xu, Xu, Xu, Xu, Xu, Xu, Xu, Xu, Xu, Xu, Xu, Xu, Xu, Xu, Xu, Xu, Xu, Xu, Xu, Xu, Xu, Xu, Xu, Xu, Rr, Rr
Xu, Xu, Xu, Xu, Xu, Xu, Xu, Xu, Xu, Xu, Xu, Xu, Xu, Xu, Xu, Xu, Qxu, Xu, Qxu, Uh, Uu, Uh, Qxu, Qxu, Xu, Xu, Xu, Xu, Xu, Xu, Wog, Uue, Ur, Ur, Rr, Rr
Xu, Xu, Xu, Xu, Uh, Ce, Ce, Ket, Xu, Xu, Xu, Xu, Uue, Wog, Wog, Qxu, Qxu, Qxu, Qxu, Qxu, Qxu, Qxu, Qxu, Qxu, Wog, Wog, Wog, Wog, Wog, Wog, Wog, Wog, Wog^Bw/r, Ur, Tb^Tfi, Xu
Xu, Xu, Xu, Uu, Uu, Uh, Ur^Edb, Ce, Ce, Xu, Xu, Uu, Uue, Wog, Wog, Wog, Wog, Wog, Wog, Wog, Wog, Qxu, Wog, Wog, Wog, Wog, Uue^Em, Wog, Rb, Wog, Wog, Wog, Wog, Uue, Xu, Xu
Xu, Xu, Uu, Uu^Vu, Ur, Uu^Edb, Rb^Edb, Ce, Ce, Xu, Xu, Uhe, Uhe, Uue, Uue, Uue, Uue, Wog, Uue, Wog, Wog, Wog, Wog, Wog, Wog, Uue^Emf, Uue^Em, Rb^Edb, Uue^Em, Wog^Bw/r, Wog, Wog, Wog, Uhe, Wog, Xu
Xu, Xu, Xu, Uu, Rb^Edb, Uu^Edb, Uu^Edb, Ur, Ce, Xu, Xu, Xu, Xu, Uhe, Uu, Uu, Uu, Uue, Uu, Uue, Uue, Wog, Wwg, Wwg, Ww, Wog^Bw|r, Wog, Wog, Wog, Wog, Wog, Wog, Wog, Wog, Wog, Wog
Xu, Xu, Uh, Rb, Ur^Edb, Rb, Rb, Rb^Edb, Rb^Edb, Ce, Ce, Xu, Xu, Xu, Uh, Uu, Rb^Edb, Uu, Ur, Uu, Uu, Uue, Uue, Uue, Uhe, Wwg^Bw|r, Wwrg, Wwg, Wwg, Wwg, Wwg, Wog, Wog, Wog, Wog, Wog
Xu, Xu, Uu, Uh, Ur^Edb, Ur, Ur, Rb, Uh, Uh, Uu, Xu, Xu, Xu, Xu, Rb, Uu, Ur^Edb, Uu^Edb, Uu, Uu^Edb, Uu, Uu, Uh, Uh, Ur, Uhe, Uhe, Uue, Wwg, Ww, Ww, Ww, Wwg, Ww, Wog
Xu, Xu, Uu, Uu, Uu, Uu^Edb, Rb^Edb, Uh, Ur, Rb^Edb, Rb, Rb, Xu, Xu, Xu, Uu, Uu, Uu, Uh^Edb, Uh^Edb, Uh, Uu, Ur, Rb, Rb, Ur, Ur, Ur, Ur, Uue, Rb, Ww, Uhe, Uhe, Ww, Ww
Xu, Xu, Xu, Uu, Rb, Rb, Uu^Edb, Rb, Uu, Uh, Xu, Xu, Xu, Xu, Xu, Uu, Uu, Uu, Uh^Edb, Uh, Ur, Ur, Rb, Ur, Rb, Uu, Xu, Xu, Xu, Ur, Rb^Edb, Rb^Edb, Xu, Xu, Xu, Ww
Xu, Xu, Xu, Xu, Uu, Uu, Uu, Uu^Edb, Xu, Rb^Edb, Uu^Vu, Rb, Xu, Xu, Xu, Ur, Ur^Edb, Uu^Edb, Uh, Ur, Rb, Rb, Ur, Uh, Ur, Rb, Rb, Xu, Xu, Ur^Edb, Rb^Edb, Uu, Xu, Xu, Xos, Xu
Xu, Xu, Xu, Xu, Uh, Uh, Ur^Edb, Ur, Xu, Ur^Edb, Uu, Uh, Xu, Xu, Ur, Ur^Edb, Ur^Edb, Ur^Edb, Rb, Ur, Uu, Uu, Uu, Ur, Rb, Rb, Uh, Xos, Xu, Uu, Xu, Xu, Xos, Xos, Uu, Xos
Xu, Xu, Xu, Uh, Ce, Ur^Edb, Ur, Xu, Xu, Xu, Xu, Xu, Xu, Xu, Ur, Ur^Edb, Ur, Ur, Ur, Rb, Uh, Rb, Qlf, Uu, Qlf, Uh, Qlf, Xos, Xu, Xu, Xos, Xos, Cud, Uu, Urb, Uu
Xu, Xu, Ket, Ce, Rb^Edb, Ce, Ur, Rr, Rr, Xu, Xu, Xu, Rb, Ur, Ur, Uu, Rb, Rb, Rb, Rb, Ur, Qxu, Qxu, Qlf, Ql, Qlf, Ias, Xos, Xos, Xos, Cud, Cud, Urb^Edb, Urb^Edb, Urb, Urb
Xu, Xu, Xu, Rb, Uu^Vu, Ur, Xu, Xu, Xu, Rr^Pr/, Ur, Ur, Ur, Ur, Rb^Edb, Rb^Edb, Ur, Ur, Uh, Rb, Ur^Edb, Ur, Qxu^Bs\, Qxu, Qxu, Ql, Ias, Ias, Xos, Xos, Cud, Kud, Uu, Urb, Uu, Urb
Xu, Xu, Xu, Uh, Uh, Rb, Xu, Xu, Xu, Rb, Uu, Uu, Uu, Ur^Edb, Rb, Ur, Uu, Uu, Qlf, Uh, Qlf, Qxu, Qxu, Ur, Qxu^Bs\, Qxu, Ias, Ias, Xos, Xos, Xos, Cud, Cud, Uu, Uu, Uu
Xu, Xu, Xu, Uh, Xu, Uh, Xu, Xu, Qlf, Qlf, Qlf, Qlf, Qlf, Ur, Qxu^Bs|, Uu, Ql, Qlf, Qlf, Qlf, Ql, Ql, Ql, Qxu, Ias, Ias, Ias, Ias, Ias, Xos, Xos, Xos, Xos, Cud, Urb, Urb^Edb
Xu, Xu, Xu, Xu, Xu, Xu, Xu, Xu, Qlf, Qlf, Ql, Qlf, Qxu, Qxu, Ur, Qxu, Ql, Ql, Ql, Ql, Ql, Ql, Ql, Ias, Ias, Ias, Ias, Ias, Ias, Ias, Ias, Xos, Xos, Xos, Urb, Urb
Xu, Xu, Xu, Xu, Xu, Xu, Qlf, Qlf, Ql, Ql, Ql, Ql, Qxu, Qxu, Qxu^Bs|, Qxu, Qxu, Ql, Ql, Ql, Ql, Ql, Ql, Qlf, Qlf, Ias, Ias, Ias, Ias, Ias, Ias, Ias, Ias, Urb, Urb, Urb
Xu, Xu, Xu, Xu, Xu, Qlf, Qlf, Ql, Ql, Ql, Ql, Ql, Qxu, Qxu, Urb, Qxu, Qxu, Qxu, Ql, Ql, Ql, Ql, Qlf, Qlf, Ias, Ias, Ias, Ias, Ias, 2 Ias, Ias, 1 Ias, Ias, Urb, Urb^Edb, Urb^Edb
Xu, Xu, Qlf, Qlf, Qlf, Qlf, Ql, Ql, Ql, Ql, Qlf, Ql, Ql, Qxu, Qxu^Bs|, Qxu, Qxu, Qxu, Ql, Ql, Ql, Qlf, Qlf, Ias, Ias, Uu, Xos, Ias, Uu, Uu, Uu, Ias, Ias, Urb^Edb, Urb^Edb, Urb
Qlf, Qlf, Qlf, Qlf, Ql, Ql, Ql, Ql, Qlf, Qlf, Qlf, Qlf, Urb, Qxu, Urb, Qxu, Ql, Ql, Ql, Ql, Ql, Qlf, Qlf, Ias, Ias, Xos, Xos, Ias, Ias, Ias, Ias, Ias, Ias, Ias, Xos, Urb^Edb
Qlf, Qlf, Ql, Ql, Ql, Ql, Ql, Ql, Qlf, Qlf, Qlf, Urb, Urb^Edb, Urb^Edb, Urb^Edb, Urb, Qlf, Qlf, Qlf, Ql, Ql, Ql, Qlf, Ias, Ias, Xos, Xos, Ias, Ias, Ias, Ias, Ias, Xos, Xos, Xos, Urb^Es
Qlf, Qlf, Ql, Ql, Ql, Ql, Qlf, Qlf, Urb, Urb, Urb, Urb, Urb, Urb, Urb, Urb, Urb, Qlf, Qlf, Qlf, Qlf, Qlf, Qlf, Ias, Qxu^Bs\, Xos, Xos, Ias, Qlf, Ias, Ias, Xos, Xos, Xos, Cud, Urb^Edb
