Gll^Fmf, Gll^Fmf, Gll^Fmf, Gll^Fmf, Gll^Fdf, Gll^Fdf, Gll^Fmf, Gll^Fmf, Gll^Fdf, Gll^Fdf, Gll^Fdf, Gll^Fdf, Gll^Fdf, Gll^Fdf, Gll^Fdf, Gll^Fdf, Gll^Fmf, Gll^Fmf, Gll^Eqf, Gll^Eqf, Gll^Fmf, Gll^Fmf, Gll^Fmf, Gs, Gll^Fdf, Gg, Gg, Gg, Gll^Fdf, Gll^Fdf, Gll^Fdf, Gll^Fdf, Gll^Fdf, Gll^Fdf, Gll^Fmf, Gll^Fmf, Gll^Fmf, Gll^Fmf, Gll^Fmf, Gll^Fmf, Gll^Eqf, Gll^Eqf, Gll^Fdf, Gll^Fdf, Gll^Fdf, Gll^Fdf, Gll^Fdf, Gll^Fdf, Gll^Fdf, Gll^Fdf, Gll^Fmw, Gll^Fmw
Gll^Fmf, Gll^Fmf, Gll^Fdf, Gll^Fdf, Gll^Fdf, Gll^Fmf, Gll^Fdf, Gll^Fdf, Gll^Fdf, Gll^Fdf, Gll^Fdf, Gll^Fdf, Gll^Fdf, Gll^Fdf, Gll^Fdf, Gll^Fdf, Gll^Eqf, Gll^Eqf, Gll^Fdf, Gll^Fmf, Gll^Fdf, Gll^Fmf, Gll^Fdf, Gs, Gg, Gg, Gg, Gg, Gll^Fdf, Gll^Fdf, Gll, Gll^Fdf, Gll^Fmw, Gll^Fdf, Gll^Fmw, Gll^Fmf, Gll^Fmf, Gll^Fmf, Gll^Eqf, Gll^Eqf, Gll^Fmw, Gll^Fdf, Gll^Fmw, Gll^Fdf, Gll^Fmw, Gll^Fdf, Gll^Fdf, Gll^Fdf, Gll^Fdf, Gll^Fmw, Gll^Fmw, Gll^Fmw
Gll^Fmf, Gll^Fmf, Gll^Fdf, Gll^Fdf, Gll^Fmw, Gll^Fdf, Gll^Fdf, Gll^Fdf, Gll^Fmf, Gll^Fdf, Gll^Fmf, Gll^Fdf, Gll^Fdf, Gll^Fdf, Gll^Eqf, Gll^Eqf, Gll^Fmf, Gll^Fdf, Gll^Fmf, Gll^Fmf, Gll^Fmw, Gll^Fmf, Gll^Fmf, Gg, Gg^Fet, Gs, Gg, Gll^Fmw, Gll^Fmw, Gll, Gll, Gll, Gll^Fmw, Gll^Fmw, Gll^Fmf, Gll^Fmf, Gll^Eqf, Gll^Eqf, Gll^Fmw, Gll^Fmw, Gll^Fmw, Gll^Fmw, Gll^Fmw, Gll^Fmw, Gll^Fdf, Gll^Fdf, Gll^Fmf, Gll^Fmf, Gll^Fmf, Gll^Fmw, Gll^Fdf, Gll^Fdf
Gll^Fmf, Gll^Fmf, Gll^Fmw, Gll^Fmw, Gll^Fmw, Gll^Fdf, Gll^Fmf, Gll^Fmf, Gll^Fmf, Gll^Fmf, Gll^Fmf, Gll^Fmf, Gll^Eqf, Gll^Eqf, Gll^Fdf, Gll^Fdf, Gll^Fdf, Gll^Fmf, Gll, Gll, Gll, Gll, Gll, Gll, Gs, Gg, Gll, Gll^Fmw, Gll, Gll, Gll^Fmf, Gll^Fmw, Gll^Fdf, Gll^Fmf, Gll^Eqf, Gll^Eqf, Gll^Fmf, Gll^Fmf, Gll^Fdf, Gll^Fmw, Gll^Fdf, Gll^Fmw, Gll^Fmf, Gll^Fdf, Gll^Fmf, Gll^Fmf, Gll^Fmf, Gll^Fmf, Gll^Fmw, Gll^Fmf, Gll^Fdf, Gll^Fdf
Gll^Fmf, Gll^Fmf, Gll^Fmw, Gll^Fmw, Gll^Fmw, Gll^Fmf, Gll^Fmf, Gll^Fmf, Gll^Fmf, Gll^Fmf, Gll^Eqf, Gll^Eqf, Gll^Fdf, Gll^Fdf, Gll^Fdf, Gll^Fdf, Gll^Fdf, Gll, Gll, Gll^Fmw, Gll^Fdf, Gll^Fdf, Gg, Gll^Dr, 1 Gg, Gg, Gll^Fdf, Gll^Fdf, Gll^Fdf, Gll^Fdf, Gll^Fdf, Gll^Fdf, Gll^Eqf, Gll^Eqf, Gll^Fdf, Gll^Fdf, Gll^Fdf, Gll^Fmf, Gll^Fmf, Gll^Fdf, Gll^Fdf, Gll^Fmf, Gll^Fmw, Gll^Fmf, Gll^Fmf, Gll^Fmf, Gll^Fmw, Gll^Fmw, Gll^Fmw, Gll^Fmw, Gll^Fdf, Gll^Fdf
Gll^Fdf, Gll^Fdf, Gll^Fmw, Gll^Fmw, Gll^Fdf, Gll^Fmf, Gll^Fmf, Gll^Fmf, Gll^Fmf, Gll^Fdf, Gll^Fdf, Gll^Eqf, Gll^Eqf, Gll^Fdf, Gll^Fmf, Gll^Fdf, Gll^Fdf, Gll^Fmw, Gll^Fdf, Gll^Fdf, Gll^Fdf, Gll^Fdf, Gg, Gg, Gs, Gs, Gll^Fmw, Gll^Fmw, Gll^Fdf, Gll^Fdf, Gll^Eqf, Gll^Eqf, Gll^Fdf, Gll^Fdf, Gll^Fmf, Gll^Fdf, Gll^Fmf, Gll^Fmf, Gll^Fmf, Gll^Fdf, Gll^Fmw, Gll^Fmw, Gll^Fmw, Gll^Fmw, Gll^Fmf, Gll^Fmf, Gll^Fmw, Gll^Fmw, Gll^Fdf, Gll^Fdf, Gll^Fdf, Gll^Fdf
Gll^Fdf, Gll^Fdf, Gll^Fdf, Gll^Fdf, Gll^Fdf, Gll^Fdf, Gll^Fmf, Gll^Fmf, Gll^Fmf, Gll^Fdf, Gll^Fdf, Gll^Fdf, Gll^Fdf, Gll^Eqf, Gll^Eqf, Gll^Fmf, Gll^Fmf, Gll^Fdf, Gll^Fdf, Gll^Fdf, Gll^Fdf, Gll^Fdf, Gg, Gll^Fdf, Gs, Gs, Rp, Gll^Fdf, Gll^Fdf, Gll^Fdf, Gll^Fmf, Gll^Eqf, Gll^Eqf, Gll^Fdf, Gll^Fmw, Gll^Fmf, Gll^Fmf, Gll^Fmf, Gll^Fmf, Gll^Fmf, Gll^Fmf, Gll^Fmw, Gll^Fmw, Gll^Fmw, Gll^Fmf, Gll^Fmf, Gll^Fmf, Gll^Fdf, Gll^Fdf, Gll^Fdf, Gll^Fmw, Gll^Fmw
Gll^Fdf, Gll^Fdf, Gll^Fdf, Gll^Fdf, Gll^Fmw, Gll^Fdf, Gll^Fdf, Gll^Fmf, Gll^Fmf, Gll^Fdf, Gll^Fmf, Gll^Fdf, Gll^Fdf, Gll^Fdf, Gll^Eqf, Gll^Eqf, Gll^Fmw, Gll^Fdf, Gll^Fdf, Gll^Fdf, Gll^Fmf, Gll^Fdf, Gll^Fmw, Gg, Gs, Rp, Gg, Gll, Gll^Fdf, Gll^Fdf, Gll^Fmw, Gll^Fmw, Gll^Fmw, Gll^Eqf, Gll^Eqf, Gll^Fdf, Gll^Fmw, Gll^Fmf, Gll^Fmf, Gll^Fdf, Gll^Fdf, Gll^Fmw, Gll^Fdf, Gll^Fdf, Gll^Fdf, Gll^Fmf, Gll^Fmf, Gll^Fmf, Gll^Fmw, Gll^Fmw, Gll^Fmw, Gll^Fmw
Gll^Fdf, Gll^Fdf, Gll^Fmw, Gll^Fmw, Gll^Fdf, Gll^Fdf, Gll^Fdf, Gll^Fdf, Gll^Fdf, Gll^Fdf, Gll^Fdf, Gll^Fmf, Gll^Eqf, Gll^Eqf, Gll^Fmw, Gll^Fmw, Gll^Fdf, Gll^Fdf, Gll, Gll, Rd, Gll^Fmw, Gg, Gs, Gs, Gs, Gll, Gll^Fdf, Gll, Gll^Fmw, Gll^Fmw, Gll^Fmw, Gll^Fdf, Gll^Fdf, Gll^Fmw, Gll^Eqf, Gll^Eqf, Gll^Fdf, Gll^Fdf, Gll^Fdf, Gll^Fdf, Gll^Fdf, Gll^Fmf, Gll^Fdf, Gll^Fdf, Gll^Fdf, Gll^Fmw, Gll^Fmw, Gll^Fmw, Gll^Fmw, Gll^Fmf, Gll^Fdf
Gll^Fdf, Gll^Fdf, Gll^Fdf, Gll^Fdf, Gll^Fdf, Gll^Fdf, Gll^Fdf, Gll^Fdf, Gll^Fdf, Gll^Fdf, Gll^Eqf, Gll^Eqf, Gll^Fdf, Gll^Fmw, Gll, Gll, Gll, Gll, Rd, Rd, Gd, Gll^Fdf, Gg, Gs, Gs, Gs, Gll^Fdf, Gll^Fdf, Gll^Fdf, Gll, Gll, Gll^Fdf, Gll^Fdf, Gll^Fdf, Gll^Fmf, Gll^Fdf, Gll^Fmw, Gll^Eqf, Gll^Eqf, Gll^Fdf, Gll^Fdf, Gll^Fdf, Gll^Fdf, Gll^Fmf, Gll^Fmf, Gll^Fdf, Gll^Fmw, Gll^Fmw, Gll^Fmw, Gll^Fmw, Gll^Fdf, Gll^Fmf
Gll^Fdf, Gll^Fdf, Gll^Fmf, Gll^Fdf, Gll^Fdf, Gll^Fdf, Gll^Fdf, Gll^Fdf, Gll^Eqf, Gll^Eqf, Gll^Fdf, Gll^Fdf, Gll^Fdf, Gll^Fmw, Rd, Rd, Rd, Rd, Gd, Gd, Gs, Gs, Gs, Gs, Rp, Gll, Gll^Fmf, Gll^Fdf, Gll, Gll, Gll, Gll, Gll, Gll^Fdf, Gll^Fmw, Gll^Fmw, Gll^Eqf, Gll^Eqf, Gll^Fdf, Gll^Fdf, Gll^Fdf, Gll^Fdf, Gll^Fdf, Gll^Fdf, Gll^Fdf, Gll^Fmf, Gll^Fmw, Gll^Fmw, Gll^Fdf, Gll^Fdf, Gll^Fmw, Gll^Fmw
Gll^Fmf, Gll^Fmf, Gll^Fmf, Gll^Fdf, Gll^Fdf, Gll^Fdf, Gll^Eqf, Gll^Eqf, Rd, Rd, Gll, Rd, Rd, Gll^Fdf, Rp, Rp, Gs, Gd, Gs, Gs, Rp, Gs, Gs, Gs^Dr, Rd, Gll^Fdf, Gll, Gll, Gll^Fmf, Gll, Gll^Fdf, Gll^Fdf, Gll^Fmf, Gll^Fdf, Gll^Eqf, Gll^Eqf, Gll^Fdf, Gll^Fdf, Gll^Fdf, Gll^Fdf, Gll^Fdf, Gll^Fdf, Gll^Fdf, Gll^Fdf, Gll^Fdf, Gll^Fmf, Gll^Fmf, Gll^Fdf, Gll^Fdf, Gll^Fdf, Gll^Fmw, Gll^Fmw
Gll^Fmf, Gll^Fmf, Gll^Fmf, Gll^Fmf, Gll^Eqf, Gll^Eqf, Gll^Fdf, Gll^Fdf, Gll, Gll, Gll, Gll, Rd, Rp, Gs, Gs^Dr, Gd, Gd, Gd, Gs, Rp, Gs, Gd, Rd, Gd, Gd, Gll^Fmw, Gll^Fdf, Gll^Fdf, Gll^Fdf, Gll^Fdf, Gll^Fdf, Gll^Eqf, Gll^Eqf, Gll^Fmf, Gll^Fdf, Gll^Fdf, Gll^Fdf, Gll^Fdf, Gll^Fdf, Gll^Fmw, Gll^Fmw, Gll^Fmw, Gll^Fdf, Gll^Fdf, Gll^Fmf, Gll^Fmf, Gll^Fmf, Gll^Fmw, Gll^Fdf, Gll^Fdf, Gll^Fdf
Gll^Fmf, Gll^Fmf, Gll^Eqf, Gll^Eqf, Gll^Fmw, Gll^Fdf, Rd, Gll, Rd, Gll, Rd, Gll^Fdf, Gd, Gd, Gd, Gd, Gd, Gd, Hhd, Gs, Rd, Gll^Fdf, Rd, Gd, Gll^Fmw, Gd, Gll, Gll^Fmf, Gll^Fdf, Gll^Fdf, Gll^Eqf, Gll^Eqf, Gll^Fmw, Gll^Fmw, Gll^Fmf, Gll^Fdf, Gll^Fdf, Gll^Fdf, Gll^Fdf, Gll^Fmw, Gll^Fmw, Gll^Fmw, Gll^Fdf, Gll^Fdf, Gll^Fdf, Gll^Fdf, Gll^Fmw, Gll^Fmw, Gll^Fmw, Gll^Fmw, Gll^Fdf, Gll^Fdf
Gll^Eqf, Gll^Eqf, Gll^Fmf, Gll^Fmw, Gll^Fmf, Gll^Fdf, Rd, Rd, Gll, Gll, Gll, Gll, Gd, Gd, Gs, Gs, Gd, Gll, Hhd, Rd, Hhd, Gll^Fdf, Rd, Rd, Gll, Gll, Gll^Fdf, Gll^Fdf, Gll^Eqf, Gll^Eqf, Gll^Fdf, Gll^Fmw, Gll^Fmw, Gll^Fmw, Gll^Fmf, Gll^Fdf, Gll^Fdf, Gll^Fdf, Gll^Fdf, Gll^Fdf, Gll^Fdf, Gll^Fdf, Gll^Fmw, Gll^Fdf, Gll^Fdf, Gll^Fdf, Gll^Fmw, Gll^Fmw, Gll^Fmw, Gll^Fdf, Gll^Fdf, Gll^Fdf
Gll^Fmf, Gll^Fmf, Gll^Fdf, Gll^Fmf, Gll^Fmw, Gll^Fmf, Rd, Rd, Gll, Rd, Gll, Gs, Gd, Gs, Gd, Gd, Rd, Gll, Hhd, Hhd, Mm, Gll^Fdf, Gll^Fdf, Gll^Fdf, Gll^Fdf, Gll^Fdf, Gll^Eqf, Gll^Eqf, Gll^Fdf, Gll^Fdf, Gll^Fmf, Gll^Fmw, Gll^Fmw, Gll^Fmw, Gll^Fdf, Gll^Fmf, Gll^Fmf, Gll^Fdf, Gll^Fdf, Gll^Fdf, Gll^Fmw, Gll^Fmw, Gll^Fmw, Gll^Fmw, Gll^Fdf, Gll^Fmf, Gll^Fmw, Gll^Fmw, Gll^Fdf, Gll^Fdf, Gll^Fdf, Gll^Fdf
Gll^Fdf, Gll^Fdf, Gll^Fmw, Gll^Fmw, Gll^Fmw, Gll^Fmf, Rd, Gll^Fdf, Gll^Fdf, Gll^Fdf, Gll, Gd, Gll, Gd, Hhd, Hhd, Hhd, Hhd, Hhd, Mm, Mv, Mm, Gll^Fmf, Gll^Fdf, Gll^Eqf, Gll^Eqf, Gll^Fdf, Gll^Fdf, Gll^Fdf, Gll^Fdf, Gll^Fdf, Gll^Fmw, Gll^Fmf, Gll^Fmf, Gll^Fmf, Gll^Fdf, Gll^Fdf, Gll^Fmf, Gll^Fmf, Gll^Fdf, Gll^Fmw, Gll^Fmw, Gll^Fmw, Gll^Fmw, Gll^Fdf, Gll^Fmf, Gll^Fmf, Gll^Fmf, Gll^Fdf, Gll^Fdf, Gll^Fdf, Gll^Fdf
Gll^Eqf, Gll^Fdf, Gll^Fmw, Gll^Fmw, Gll^Fmw, Gll, Gll, Rd, Gll^Fdf, Gll^Fdf, Gd, Gd, Gll^Dr, Rd, Rd, Hhd, Hhd, Hhd, Hhd, Mm, Mm, Mm, Gll^Fdf, Gll^Eqf, Gll^Eqf, Gll^Fdf, Gll^Fmf, Gll^Fdf, Gll^Fdf, Gll^Fdf, Gll^Fdf, Gll^Fdf, Gll^Fdf, Gll^Fmf, Gll^Fmf, Gll^Fdf, Gll^Fdf, Gll^Fdf, Gll^Fdf, Gll^Fdf, Gll^Fmw, Gll^Fmw, Gll^Fdf, Gll^Fdf, Gll^Fdf, Gll^Fdf, Gll^Fdf, Gll^Fmf, Gll^Fdf, Gll^Fdf, Gll^Fdf, Gll^Fdf
Gll^Fdf, Gll^Eqf, Gll^Eqf, Gll^Fmw, Gll^Fdf, Gll^Fdf, Gll^Fdf, Rd, Rd, Gll^Fmw, Gd, Gd, Gll, Gll, Gll, Rd, Rd, Hhd, Mm, Mm, Hhd, Hhd, Gll^Fmw, Gll^Fdf, Gll^Fdf, Gll^Eqf, Gll^Eqf, Gll^Fmf, Gll^Fmf, Gll^Fdf, Gll^Fmw, Gll^Fmw, Gll^Fdf, Gll^Fdf, Gll^Fdf, Gll^Fmf, Gll^Fdf, Gll^Fdf, Gll^Fmw, Gll^Fmw, Gll^Fmw, Gll^Fmw, Gll^Fdf, Gll^Fdf, Gll^Fdf, Gll^Fdf, Gll^Fdf, Gll^Fdf, Gll^Fmw, Gll^Fdf, Gll^Fdf, Gll^Fdf
Gll^Fdf, Gll^Fdf, Gll^Fdf, Gll^Eqf, Gll^Eqf, Gll^Fmf, Gll^Fmf, Gll, Gll, Rd, Rd, Gd, Rd, Gd, Gd, Gd, Gll, Hhd, Hhd, Hhd, Hhd, Hhd, Gll^Fmw, Gll^Fdf, Gll^Fdf, Gll^Fdf, Gll^Fdf, Gll^Eqf, Gll^Eqf, Gll^Fmw, Gll^Fdf, Gll^Fdf, Gll^Fdf, Gll^Fdf, Gll^Fdf, Gll^Fdf, Gll^Fmf, Gll^Fmw, Gll^Fmw, Gll^Fmw, Gll^Fdf, Gll^Fdf, Gll^Eqf, Gll^Eqf, Gll^Eqf, Gll^Fdf, Gll^Fmw, Gll^Fmw, Gll^Fmw, Gll^Fdf, Gll^Fmw, Gll^Fmw
Gll^Fmf, Gll^Fmf, Gll^Fdf, Gll^Fdf, Gll^Fmw, Gll^Eqf, Gll^Eqf, Gll^Fmf, Gll^Fdf, Gll, Gll, Rd, Gd, Gd, Gd, Gd, Gd, Gll, Gd, Gll^Fdf, Gd, Hhd, Gll^Fdf, Gll^Fdf, Gll^Fdf, Gll^Fdf, Gll^Fdf, Gll^Fdf, Gll^Fdf, Gll^Eqf, Gll^Eqf, Gll^Fmw, Gll^Fdf, Gll^Fdf, Gll^Fdf, Gll^Fdf, Gll^Fdf, Gll^Fmf, Gll^Fmw, Gll^Fmw, Gll^Eqf, Gll^Eqf, Gll^Fdf, Gll^Fdf, Gll^Fdf, Gll^Eqf, Gll^Eqf, Gll^Fmw, Gll^Fdf, Gll^Fdf, Gll^Fdf, Gll^Fdf
Gll^Fmf, Gll^Fmf, Gll^Fmw, Gll^Fmw, Gll^Fmw, Gll^Fmf, Gll^Fmf, Gll^Eqf, Gll^Eqf, Gll^Fdf, Gll^Fmf, Gd, Gll^Fdf, Gll^Fdf, Gll, Gll, Gll, Gd, Gll, Gd, Gll, Gd, Gd, Gll, Gll, Gll^Fmf, Gll^Fmf, Gll^Fdf, Gll^Fdf, Gll^Fmw, Gll^Fmw, Gll^Eqf, Gll^Eqf, Gll^Fdf, Gll^Fdf, Gll^Fdf, Gll^Fdf, Gll^Fmw, Gll^Eqf, Gll^Eqf, Gll^Fdf, Gll^Fdf, Gll^Fdf, Gll^Fdf, Gll^Fdf, Gll^Fdf, Gll^Fdf, Gll^Eqf, Gll^Eqf, Gll^Fdf, Gll^Fmw, Gll^Fmw
Gll^Fmf, Gll^Fmf, Gll^Fmw, Gll^Fmw, Gll^Fmw, Gll^Fmf, Gll^Fmf, Gll^Fmf, Gll^Fdf, Gll^Eqf, Gll^Eqf, Gll^Fmw, Gll^Fmf, Gll^Fdf, Gll^Fmf, Gll, Gll^Fmw, Gll, Gd, Gll, Rd, Gll, Gd, Gd, Gd, Gll, Gd, Gll^Fmf, Gll^Fdf, Gll^Fmw, Gll^Fdf, Gll^Fdf, Gll^Fdf, Gll^Eqf, Gll^Eqf, Gll^Fdf, Gll^Eqf, Gll^Eqf, Gll^Fmf, Gll^Fmf, Gll^Fmf, Gll^Fdf, Gll^Fdf, Gll^Fdf, Gll^Fmf, Gll^Fdf, Gll^Fdf, Gll^Fdf, Gll^Fdf, Gll^Eqf, Gll^Eqf, Gll^Fdf
Gll^Fdf, Gll^Fdf, Gll^Fmw, Gll^Fmw, Gll^Fdf, Gll^Fdf, Gll^Fdf, Gll^Fmf, Gll^Fdf, Gll^Fmw, Gll^Fmw, Gll^Eqf, Gll^Eqf, Gll^Fdf, Gll^Fdf, Gll^Fmf, Gll^Fmf, Gll^Fdf, Gll^Fdf, Gd, Gd, Gd, Rd, Rd, Rd, Rd, Rd, Gd, Rd, Gll^Feth, Gll^Fdf, Gll^Fdf, Gll^Fmw, Gll^Fdf, Gll^Eqf, Gll^Eqf, Gll^Fdf, Gll^Fdf, Gll^Fdf, Gll^Fmf, Gll^Fmf, Gll^Fdf, Gll^Fmw, Gll^Fmw, Gll^Fmf, Gll^Fmf, Gll^Fmf, Gll^Fdf, Gll^Fdf, Gll^Fdf, Gll^Fmw, Gll^Eqf
Gll^Fdf, Gll^Fdf, Gll^Fdf, Gll^Fdf, Gll^Fdf, Gll^Fdf, Gll^Fdf, Gll^Fdf, Gll^Fdf, Gll^Fmw, Gll^Eqf, Gll^Eqf, Gll^Fmf, Gll^Eqf, Gll^Eqf, Gll^Fdf, Gll^Fdf, Gll^Fdf, Gll^Fmw, Gll^Fdf, Gll^Fmw, Gd, Gll^Fdf, Gll, Gd, Gll^Fmw, Gd, Rd, Gd, Rd, Gll, Gll^Fmw, Gll^Eqf, Gll^Eqf, Gll^Fdf, Gll^Fdf, Gll^Fdf, Gll^Fdf, Gll^Fmf, Gll^Fmf, Gll^Fmf, Gll^Fmw, Gll^Fmw, Gll^Fmw, Gll^Fdf, Gll^Fmf, Gll^Fmf, Gll^Fmf, Gll^Fmw, Gll^Fdf, Gll^Fdf, Gll^Fdf
Gll^Fdf, Gll^Fdf, Gll^Fdf, Gll^Fdf, Gll^Fmw, Gll^Fdf, Gll^Fmf, Gll^Fdf, Gll^Eqf, Gll^Eqf, Gll^Fdf, Gll^Fdf, Gll^Fdf, Gll^Fmf, Gll^Fmf, Gll^Eqf, Gll^Eqf, Gll^Fmw, Gll^Fmw, Gll^Fmw, Gll^Fmw, Gll^Fmw, Gll^Fdf, Gll^Fdf, Gll^Fdf, Gd, Gll^Fmf, Gll^Fmw, Gll^Fmw, Gd, Gll, Gll, Gll^Fmw, Gll^Eqf, Gll^Eqf, Gll^Fdf, Gll^Fdf, Gll^Fdf, Gll^Fmf, Gll^Fmf, Gll^Fmf, Gll^Fmf, Gll^Fmw, Gll^Fmw, Gll^Fdf, Gll^Fdf, Gll^Fmw, Gll^Fmw, Gll^Fdf, Gll^Fdf, Gll^Fdf, Gll^Fdf
Gll^Fmw, Gll^Fmw, Gll^Fmw, Gll^Fmw, Gll^Fmw, Gll^Fdf, Gll^Eqf, Gll^Eqf, Gll^Fmf, Ur, Ur, Ur, Uhe, Uhe, Uhe, Gll^Fdf, Uhe, Gll^Eqf, Gll^Eqf, Gll^Fmw, Gll^Fdf, Gll^Fdf, Gll^Fdf, Gll^Fdf, Gll^Fdf, Gll^Fdf, Gll^Fdf, Gll^Fmw, Gll^Eqf, Gll^Eqf, Gll, Rd, Gll, Gll^Fmw, Gll^Fdf, Gll^Eqf, Gll^Eqf, Gll^Fmf, Gll^Fmf, Gll^Fmf, Gll^Fmf, Gll^Fmw, Gll^Fmf, Gll^Fmf, Gll^Fdf, Gll^Fmf, Gll^Fmf, Gll^Fdf, Gll^Fdf, Gll^Fdf, Gll^Fdf, Gll^Fdf
Gll^Fmw, Gll^Fmw, Gll^Fmw, Gll^Fmw, Gll^Eqf, Gll^Eqf, Gll^Fmf, Gll^Fmf, Gll^Fmf, Ur, Uhe, Uhe, Ur, Ur, Ur, Uhe, Uhe, Uhe, Gll^Fmw, Gll^Eqf, Gll^Eqf, Gll^Fdf, Gll^Fdf, Gll^Fdf, Gll^Fmw, Gll^Fdf, Gll^Eqf, Gll^Eqf, Gll^Fmw, Gll^Fmw, Gll^Fdf, Rd, Gll, Gll^Fdf, Gll^Fdf, Gll^Fmf, Gll^Fmf, Gll^Eqf, Gll^Eqf, Gll^Fmf, Gll^Fmf, Gll^Fmf, Gll^Fmf, Gll^Fmf, Gll^Fmf, Gll^Fmf, Gll^Fmf, Gll^Fmf, Gll^Fmw, Gll^Fdf, Gll^Fdf, Gll^Fdf
Gll^Fmw, Gll^Fmw, Gll^Eqf, Gll^Eqf, Gll^Fdf, Gll^Fdf, Ur, Gll^Fmf, Uhe, Uhe, Ur, Ur, Uhe, Ur, Gll^Fmw, Ur, Ur, Uhe, Uhe, Gll^Fdf, Gll^Fdf, Gll^Eqf, Gll^Eqf, Gll^Fmw, Gll^Eqf, Gll^Eqf, Gll^Fdf, Gll^Fmw, Gll^Fmw, Gll^Fmw, Rd, Rd, Rd, Gll^Fmf, Gll^Fmf, Gll^Fdf, Gll^Fmw, Gll^Fdf, Gll^Fmf, Gll^Eqf, Gll^Eqf, Gll^Fmf, Gll^Fmw, Gll^Fmw, Gll^Fdf, Gll^Fmf, Gll^Fmw, Gll^Fmw, Gll^Fmw, Gll^Fdf, Gll^Fdf, Gll^Fdf
Gll^Eqf, Gll^Eqf, Gll^Fmw, Gll^Fdf, Ur, Ur, Gll^Fdf, Uhe, Ur, Uhe, Gll^Fdf, Ur, Uhe, Gll^Fdf, Rb, Ur, Ur, Ur, Gll^Fmf, Gll^Fmf, Gll^Fmf, Gll^Fdf, Gll^Fmw, Gll^Eqf, Gll^Eqf, Gll^Fdf, Gll^Fdf, Gll^Fmw, Gll, Rd, Rd, Rd^Ecf, Rd, Gll^Fdf, Gll^Fmw, Gll^Fmw, Gll^Fmw, Gll^Fdf, Gll^Fmf, Gll^Fmf, Gll^Eqf, Gll^Eqf, Gll^Fmw, Gll^Fmw, Gll^Fdf, Gll^Fdf, Gll^Fmw, Gll^Fmw, Gll^Fdf, Gll^Fdf, Gll^Fdf, Gll^Fdf
Ur, Ur, Ur, Gll^Fdf, Ur, Ur, Ur, Uhe, Ur, Ur, Rb, Gll^Fdf, Rb, Uhe, Gll^Feth, Gll^Fmw, Gll^Fmw, Ur, Rb, Rb, Rb, Rb, Rb, Gll^Fdf, Gll, Gll^Eqf, Rd, Gll^Fmw, Rd, Rd, Gll, Gll, Gll^Fdf, Gll^Fdf, Gll^Fmw, Gll^Fmw, Gll^Fmw, Gll^Fmw, Gll^Eqf, Gll^Eqf, Gll^Fmf, Gll^Fmw, Gll^Fmf, Gll^Fmf, Gll^Fdf, Gll^Fdf, Gll^Fdf, Gll^Fdf, Gll^Fdf, Gll^Fdf, Gll^Fdf, Gll^Fdf
Gll^Fdf, Ur, Ur, Ur, Gll^Fmw, Rb, Rb, Uhe, Rb, Rb, Rb, Gll^Fdf, Rb, Gll, Gll, Gll, Rd, Gll, Rd, Rd^Ecf, Rd, Rd, Rd, Rd, Rd, Rd, Gll, Rd, Gll^Eqf, Gll^Fmf, Gll^Fmf, Gd^Fetd, Gll^Fdf, Gll^Fdf, Gll^Fdf, Gll^Fmw, Gll^Eqf, Gll^Eqf, Gll^Fmf, Gll^Fmf, Gll^Fdf, Gll^Fmf, Gll^Fmf, Gll^Fmf, Gll^Fmf, Gll^Fdf, Gll^Fdf, Gll^Fdf, Gll^Fmw, Gll^Fdf, Gll^Fdf, Gll^Fdf
Gll^Fdf, Ur, Gll^Fmw, Gll^Fmw, Rb, Rb, Rb, Rb, Ias, Ias, Ias, Rb, Rb, Rb, Rb, Rd, Rb, Gll, Rb, Rb, Rb, Rb, Rb, Rb, Ur, Gll, Gll^Fmw, Gll^Fmw, Gll^Fdf, Gll^Eqf, Gll^Eqf, Gll^Fdf, Gll^Fmw, Gll^Fdf, Gll^Eqf, Gll^Eqf, Gll^Fdf, Gll^Fdf, Gll^Fdf, Gll^Fdf, Gll^Fdf, Gll^Fmf, Gll^Fmf, Gll^Fmf, Gll^Fdf, Gll^Fmf, Gll^Fmw, Gll^Fmw, Gll^Fdf, Gll^Fdf, Gll^Fdf, Gll^Fdf
Gll^Fdf, Ur, Ur, Ur, Uhe, Uhe, Rb, Ias, Ias, Ias, Gd, Ias, Ias, Ias, Rb, Rb, Rb, Rb, Uhe, Uhe, Uhe, Rb, Gd^Fetd, Ur, Ur, Ur, Ur, Ur, Ur, Gll^Fdf, Gll^Fmw, Gll^Eqf, Gll^Eqf, Gll^Eqf, Gll^Fdf, Gll^Fdf, Gll^Fdf, Gll^Fdf, Gll^Fdf, Gll^Fdf, Gll^Fdf, Gll^Fdf, Gll^Fdf, Gll^Fmf, Gll^Fmf, Gll^Fdf, Gll^Fdf, Gll^Fdf, Gll^Fdf, Gll^Fdf, Gll^Fmw, Gll^Fmw
Gll^Fdf, Gll^Fdf, Rb, Rb, Uhe, Uhe, Uhe, Ias, Ias, Gd^Fetd, Gd, Gd, Gd, Ias, Rb, Rb, Uhe, Ur, Ur, Ur, Ur, Uhe, Uhe, Gll^Fdf, Gll^Fdf, Ur, Ur, Ur, Ur, Gll^Fmw, Gll^Eqf, Gll^Eqf, Gll^Fdf, Gll^Fdf, Gll^Fdf, Gll^Fdf, Gll^Fmw, Gll^Fdf, Gll^Fmf, Gll^Fdf, Gll^Fdf, Gll^Fdf, Gll^Fdf, Gll^Fdf, Gll^Fmf, Gll^Fmf, Gll^Fmf, Gll^Fdf, Gll^Fdf, Gll^Fdf, Gll^Fmw, Gll^Fmw
Gll^Fmw, Gll^Fmw, Ur, Ur, Ur, Uhe, Rb, Uhe, Uhe, Uhe, 2 Uhe, Gd, Gll^Feth, Gll, Gll^Fdf, Uhe, Ur, Ur, Ur, Ur, Uhe, Ur, Ur, Gll^Fdf, Ur, Ur, Ur, Ur, Gll^Eqf, Gll^Eqf, Gll^Fdf, Gll^Fdf, Gll^Fdf, Gll^Fdf, Gll^Fmw, Gll^Fmw, Gll^Fdf, Gll^Fdf, Gll^Fmf, Gll^Fmf, Gll^Fmf, Gll^Fdf, Gll^Fdf, Gll^Fdf, Gll^Fmf, Gll^Fmf, Gll^Fmf, Gll^Fmf, Gll^Fdf, Gll^Fdf, Gll^Fmw, Gll^Fmw
Gll^Fdf, Gll^Fdf, Ur, Rb, Ur, Uhe, Rb, Ias, Ias, Ias, Ias, Uhe, Gll, Gll, Rb, Uhe, Uhe, Rb, Uhe, Uhe, Ur, Ur, Ur, Ur, Gll^Fmf, Ur, Gll^Eqf, Gll^Eqf, Gll^Fmw, Gll^Fmw, Gll^Fmw, Gll^Fdf, Gll^Fmf, Gll^Fdf, Gll^Fmf, Gll^Fdf, Gll^Fdf, Gll^Fdf, Gll^Fdf, Gll^Fmf, Gll^Fmf, Gll^Fdf, Gll^Fmw, Gll^Fdf, Gll^Fmw, Gll^Fmf, Gll^Fmw, Gll^Fmf, Gll^Fdf, Gll^Fdf, Gll^Fmw, Gll^Fmw
Gll^Fdf, Gll^Fdf, Ur, Rb, Gll^Fdf, Gll^Fmf, Rb, Rb, Rb, Ias, Ias, Ias, Ias, Rb, Rb, Rb, Rb, Uhe, Ur, Ur, Ur, Ur, Gll^Fdf, Gll^Fmf, Gll^Eqf, Gll^Eqf, Gll^Fmw, Gll^Fmw, Gll^Fmw, Gll^Fmw, Gll^Fmw, Gll^Fmw, Gll^Fmf, Gll^Fmf, Gll^Fmf, Gll^Fmf, Gll^Fmf, Gll^Fdf, Gll^Fdf, Gll^Fdf, Gll^Fmw, Gll^Fmw, Gll^Fmw, Gll^Fmw, Gll^Fmw, Gll^Fmw, Gll^Fmf, Gll^Fmf, Gll^Fdf, Gll^Fdf, Gll^Fmw, Gll^Fmw
Gll^Fmw, Ur, Uhe, Gll^Fdf, Rb, Rb, Gll^Fmf, Gll^Fmf, Rb, Rb, Rb, Ias, Rb, Rb, Uhe, Rb, Gll^Fmf, Rb, Ur, Ur, Gll^Fdf, Gll^Fmf, Gll^Eqf, Gll^Eqf, Gll^Fdf, Gll^Fmf, Gll^Fdf, Gll^Fmw, Gll^Fmf, Gll^Fmw, Gll^Fmf, Gll^Fmf, Gll^Fmf, Gll^Fmf, Gll^Fdf, Gll^Fmf, Gll^Fmf, Gll^Fmf, Gll^Fmf, Gll^Fmw, Gll^Fmw, Gll^Fmw, Gll^Fmf, Gll^Fmw, Gll^Fmf, Gll^Fmf, Gll^Fmf, Gll^Fdf, Gll^Fdf, Gll^Fdf, Gll^Fmw, Gll^Fmw
Gll^Fmw, Uhe, Uhe, Uhe, Uhe, Uhe, Uhe, Uhe, Uhe, Gll^Fmf, Gll^Fmf, Rb, Uhe, Rb, Uhe, Uhe, Uhe, Uhe, Gll^Fdf, Gll^Fdf, Gll^Eqf, Gll^Eqf, Gll^Fdf, Gll^Fmf, Gll^Fdf, Gll^Fdf, Gll^Fdf, Gll^Fdf, Gll^Fdf, Gll^Fmf, Gll^Fdf, Gll^Fmf, Gll^Fdf, Gll^Fmf, Gll^Fdf, Gll^Fdf, Gll^Fmw, Gll^Fmw, Gll^Fmw, Gll^Fmw, Gll^Fmw, Gll^Fmw, Gll^Fmw, Gll^Fmf, Gll^Fdf, Gll^Fmf, Gll^Fdf, Gll^Fdf, Gll^Fmw, Gll^Fmw, Gll^Fmw, Gll^Fmw
Gll^Fmw, Uhe, Ur, Gll^Fmw, Gll^Fmw, Uhe, Ur, Uhe, Uhe, Rb, Uhe, Uhe, Ur, Uhe, Gll^Fdf, Gll^Fdf, Gll^Fmw, Gll^Fdf, Gll^Eqf, Gll^Eqf, Gll^Fdf, Gll^Fdf, Gll^Fdf, Gll^Fdf, Gll^Fdf, Gll^Fdf, Gll^Fmw, Gll^Fmw, Gll^Fmw, Gll^Fdf, Gll^Fmw, Gll^Fdf, Gll^Fdf, Gll^Fdf, Gll^Fmw, Gll^Fmw, Gll^Fmf, Gll^Fmw, Gll^Fmf, Gll^Fmw, Gll^Fmf, Gll^Fmw, Gll^Fmw, Gll^Fdf, Gll^Fdf, Gll^Fdf, Gll^Fdf, Gll^Fmw, Gll^Fmw, Gll^Fmw, Gll^Fmw, Gll^Fmw
Gll^Fmw, Gll^Fmw, Gll^Fmw, Ur, Gll^Fmw, Gll^Fmw, Gll^Fmw, Ur, Gll^Fdf, Gll^Fdf, Gll^Fdf, Ur, Ur, Gll^Fdf, Gll^Fmw, Gll^Fmw, Gll^Eqf, Gll^Eqf, Gll^Fdf, Gll^Fdf, Gll^Fdf, Gll^Fdf, Gll^Fdf, Gll^Fdf, Gll^Fmw, Gll^Fmw, Gll^Fmw, Gll^Fmw, Gll^Fmw, Gll^Fmw, Gll^Fdf, Gll^Fdf, Gll^Fdf, Gll^Fdf, Gll^Fmf, Gll^Fmf, Gll^Fmf, Gll^Fmf, Gll^Fmf, Gll^Fmf, Gll^Fmw, Gll^Fmw, Gll^Fmw, Gll^Fmw, Gll^Fdf, Gll^Fdf, Gll^Fdf, Gll^Fmw, Gll^Fmw, Gll^Fmw, Gll^Fmw, Gll^Fmw
