Gll^Fdw, Gll^Fdw, Rb^Edb, Rb^Edb, Uu, Uhe^Edb, Uhe^Edb, Ias, Ias, Gd^Fetd, Gd, Gd, Gd, Ias, Rb^Edb, Rb^Edb, Uhe, Ur^Edb, Ur^Edb, Ur^Edb, Ur^Edb, Uhe, Uhe, Ss, Chs, Ss, Ur, Uu^Vu, Uu, Gll^Fdw, Gll^Fdw, Gll^Fdw, Gll, Gll^Fdf, Rb, Rb, Gll^Fdw, Gll^Fdf, Gll^Fdw, Gll^Fdf, Gll^Fdf, Gll^Fdf, Gll^Fdf, Gll^Fdf, Gll^Fdw, Gll^Fdw, Gll, Gll^Fdf, Gll^Fdf, Sm, Sm, Sm
Gll^Fdw, Gll^Fdw, Ur^Edb, Ur^Edb, Uu^Vu, Uu, Ss, Uhe^Edb, Uhe^Edb, Uhe^Edb, Uhe^Edb, Gd, Gll^Feth, Gll, Sm, Uhe^Edb, Ur^Edb, Ur^Edb, Ur^Edb, Ur^Edb, Uhe, Ur^Edb, Ss, Chs, Sm, Sm, Ur, Uu, Gll^Fdw, Gll^Fdw, Gll^Fdf, Gll, Gll^Fdf, Gll, Gll^Fdw, Gll^Fdw, Gll^Fdf, Gll^Fdf, Gll^Fdw, Gll^Fdw, Gll^Fdw, Gll^Feth, Gll^Fdf, Gll^Fdf, Gll^Fdw, Gll^Fdw, Gll^Fdw, Gll, Gll^Fdf, Gll^Fdf, Gll^Fdw, Sm
Gll^Fdw, Gll^Fdw, Ur^Edb, Rb^Edb, Sm, Sm, Ss, Ss, Ss, Ias^Edb, Ias^Edb, Uhe^Edb, Gll, Gll, Rb^Edb, Uhe, Uhe, Rb, Uhe, Uhe, Ur^Edb, Sm, Ss, Khs, Sm, Ur, Ur, Gll^Fdw, Gll^Fdw, Gll^Fdw, Gll^Fdw, Gll^Fdf, Gll^Fdw, Rb, Gll^Fdw, Gll^Fdf, Gll^Fdf, Gll^Fdf, Gll^Fdf, Gll^Fdw, Gll^Fdw, Gll^Fdf, Gll^Fdw, Gll^Fdf, Gll^Fdw, Gll^Fdw, Gll^Fdw, Gll, Rb, Gll^Fdf, Gll^Fdw, Sm
Gll^Fdw, Gll^Fdw, Ur^Edb, Rb^Edb, Ss, Ss, Chs, Chs, Chs, Ss, Sm, Ias^Edb, Ias^Edb, Rb^Edb, Rb^Edb, Rb^Edb, Rb^Edb, Uhe, Ur^Edb, Ur^Edb, Sm, Sm, Ss, Gll^Fdw, Gll^Fdw, Ur, Gll^Fdw, Rb, Rb, Gll^Fdw, Gll^Fdw, Gll^Fdw, Gll^Fdw, Rb, Gll, Gll, Gll, Gll^Fdf, Gll^Fdf, Gll^Fdf, Rb, Gll^Fdw, Gll^Fdw, Gll^Fdw, Gll^Fdw, Gll^Fdw, Rb, Rb, Gll^Fdf, Gll^Fdf, Gll^Fdw, Sm
Gll^Fdw, Ur^Edb, Uhe^Edb, Ss, Ss, Ss, Sm, 1 Khs, Chs, Ss, Ss, Sm, Sm, Rb^Edb, Uu^Edb, Rb^Edb, Gll^Fdw, Rb^Edb, Ur^Edb, Ur^Edb, Sm, Sm, Sm, Gll^Fdw, Gll^Fdf, Gll^Fdw, Gll^Fdf, Gll^Fdw, Gll^Fdw, Rb, Gll, Gll^Fdw, Rb, Rb, Gll^Fdf, Gll^Fdw, Gll^Fdw, Rb, Gll, Gll, Gll, Gll, Gll, Gll^Fdw, Rb, Rb, Gll, Gll^Fdf, Gll^Fdf, Gll^Fdf, Gll^Fdw, Gll^Fdw
Gll^Fdw, Uhe^Edb, Uhe^Edb, Uhe^Edb, Uhe^Edb, Uhe^Edb, Uhe^Edb, Uhe^Edb, Uhe^Edb, Chs, Ss, Ss, Uhe^Edb, Uu^Vu, Uhe^Edb, Uhe^Edb, Uhe^Edb, Uhe^Edb, Sm, Sm, Sm, Sm, Gll^Fdf, Gll^Fdw, Gll^Fdf, Gll^Fdf, Gll^Fdf, Gll^Fdf, Rb, Rb, Gll^Fdf, Gll, Gll^Fdf, Gll^Fdw, Gll^Fdf, Gll^Fdf, Gll^Fdw, Gll^Fdw, Gll^Fdw, Gll^Fdw, Gll^Fdw, Gll^Fdw, Gll, Gll, Rb, Gll, Rb, Rb, Gll, Gll^Fdw, Gll, Gll
Gll^Fdw, Uhe^Edb, Ur^Edb, Gll^Fdw, Gll^Fdw, Uhe^Edb, Ur^Edb, Uhe^Edb, Uhe^Edb, Ss, Uhe^Edb, Uhe^Edb, Ur^Edb, Uhe^Edb, Sm, Sm, Gll^Fdw, Sm, Gll^Fdw, Gll^Fdw, Gll^Fdf, Gll^Fdf, Gll^Fdf, Gll^Fdf, Gll^Fdf, Gll^Fdf, Gll^Fdw, Gll^Fdw, Rb, Gll^Fdf, Gll^Fdw, Gll^Fdf, Gll^Fdf, Gll^Fdf, Gll^Fdw, Gll^Fdw, Gll^Fdw, Gll^Fdw, Gll^Fdf, Gll^Fdw, Rb, Rb, Gll, Rb, Rb, Rb, Gll, Gll, Gll, Gll, Gll^Fdw, Gll^Fdw
Gll^Fdw, Gll^Fdw, Gll^Fdw, Ur^Edb, Gll^Fdf, Gll^Fdf, Gll^Fdf, Ur^Edb, Gll^Fdw, Gll^Fdw, Gll^Fdw, Ur^Edb, Ur, Sm, Gll^Fdf, Gll^Fdf, Gll^Fdf, Gll^Fdf, Gll^Fdf, Gll^Fdw, Gll^Fdf, Gll^Fdf, Gll^Fdf, Gll^Fdf, Gll^Fdw, Gll^Fdw, Gll^Fdw, Rb, Gll, Gll^Fdw, Gll^Fdf, Gll^Fdf, Gll^Fdf, Gll^Fdf, Gll^Fdw, Gll^Fdw, Rb, Gll^Fdf, Rb, Gll, Rb, Rb, Rb, Rb, Gll^Fdf, Gll^Fdf, Gll^Fdf, Gs, Gll^Fmf, Gll^Fdw, Gll^Fmf, Gll^Fdw
Gll^Fdw, Gll^Fdw, Gll^Fdw, Gll^Fdw, Ur^Edb, Gll, Gll, Ur^Edb, Gll, Gll^Fdw, Gll^Fdw, Gll^Fdw, Gll^Fdw, Gll^Fdf, Gll^Fdf, Gll^Fdf, Gll^Fdf, Gll^Fdf, Gll^Fdf, Gll^Fdw, Gll^Fdw, Gll^Fdw, Gll^Fdw, Gll^Fdw, Gll^Fdw, Gll^Fdw, Rb, Rb, Rb, Gll, Gll, Gll^Fdw, Gll, Gll, Rb, Gll, Gll, Gll, Gll, Gll, Gll^Fdw, Gll, Gll, Gll, Gll^Fdf, Gll^Fdf, Gll^Fdf, Gs, Gd, Gll^Fmf, Gll^Fmf, Gll^Fmf
Gll^Fdw, Gll^Fdw, Gll^Fdf, Gll^Fdw, Gll^Fdf, Ur^Edb, Gll, Ur^Edb, Rb, Gll, Gll^Fdw, Gll^Fdw, Gll^Fdw, Gll^Fdf, Gll^Fdf, Gll^Fdf, Gll^Fdf, Gll^Fdf, Gll^Fdf, Gll^Fdw, Gll, Gll^Fdw, Gll, Gll^Fdw, Gll, Gll, Gs, Rb, Gll, Rb, Gll, Rb, Gll, Rb, Gll, Gs^Vc, Gll^Fdf, Gll, Gll^Fmf, Gs, Gll^Fmf, Gll^Fdw, Gll^Fdw, Gll, Gll^Fdf, Gll^Fdf, Gs^Fms, Gs, Gd, Gll^Fdf, Gll^Fdf, Gll^Fmf
Gll^Fdw, Gll^Fdf, Gll^Fdf, Gll^Fdf, Gll^Fdw, Gll^Fdf, Gll^Fdf, Gll, Rb, Gll, Gll^Fdw, Gll^Fdw, Gll^Fdw, Gll^Fdw, Gll^Fdw, Gll^Fdw, Gll, Gll, Gll, Gll, Rb, Gll, Gll, Gs, Gll, Rb, Rb, Gll, Gll, Gll, Gll^Fdf, Gs, Gs, Gll^Fdf, Gll^Fdf, Gg, Gll^Fdf, Gll^Fdf, Gll^Fdw, Gs, Gll^Fmf, Gll^Fmf, Gll^Fmf, Gll^Fdw, Gll^Fdw, Gs^Fms, Gd, Gd, Gs, Gll^Fdf, Gll^Fdf, Gll^Fdf
Gll^Fdw, Gll^Fdf, Gll^Fdf, Gll^Fdf, Gll^Fdf, Gll^Fdw, Gll^Fdw, Gll, Gll, Rb, Rb, Gll^Fdw, Gll^Fdw, Gll^Fdw, Gll, Gll, Rb, Gll^Fdf, Rb, Gll, Gll, Gll, Gll, Gll, Gll^Fmf, Gll, Gll^Fdf, Gll^Fdf, Gs, Gll, Gll^Fdw, Gll^Fdw, Gll^Fdw, Gll^Fdw, Gll^Fdw, Gg, Gd, Gd, Gll^Fdf, Gll^Fdf, Gll^Fdf, Gd, Gll^Fmf, Gll^Fmf, Gll^Fmf, Gd, Gll^Fdw, Gll^Fdf, Gs, Gll^Fdf, Gs^Fms, Gs^Fms
Gll^Fdw, Gll^Fdf, Gll^Fdf, Gll^Fdf, Gll^Fmf, Gll^Fdf, Gll^Fdf, Gll, Gll, Gll, Gll, Rb, Gll, Gll, Rb, Gll, Gll, Rb, Gll, Gll, Gll^Fdw, Gll^Fdf, Gll^Fdw, Gll^Fmf, Gg, Gll^Fdf, Gll^Fdf, Gll^Fdf, Gll^Fdf, Gs, Gll, Gll^Fdw, Gd, Gll^Fdw, Gd, Gd, Gll^Fdf, Gll^Fdf, Gll^Fdf, Gll^Fdf, Gs^Fms, Gd, Gd, Gd, Gll^Fmf, Gll^Fmf, Gll^Fdf, Gs^Fms, Gs^Fms, Gs, Gs, Gs^Fms
Gll^Fdw, Gll^Fdw, Gll^Fdw, Gll^Fdf, Gll^Fdf, Gll^Fmf, Rb, Gll, Gll, Gll, Gll^Fdf, Gll, Gll^Fdf, Rb, Gll, Rb, Gll, Gll^Fdw, Gll^Fdf, Gll^Fdf, Gll^Fdf, Gll^Fdw, Gll^Fdw, Gll^Fdw, Gg, Gll^Fmf, Gs, Gd, Gll^Fdf, Gll^Fdf, Gll^Fdf, Gs, Gd, Gs, Gll^Fmf, Gll^Fdw, Gg, Gll^Fdf, Gll^Fdf, Gs^Fms, Gs, Gs, Rb, Gd, Gll^Fmf, Gll^Fmf, Gs, Gs, Gs, Gs^Fms, Gs, Gs^Fms
Gll^Fdw, Gll^Fdw, Gll^Fdw, Gll^Fdf, Gll^Fdf, Gll^Fmf, Gll^Fmf, Rb, Rb, Gll, Gll, Rb, Rb, Gll, Gll, Gll, Gll, Gll, Gll^Fdf, Gll^Fdf, Gll^Fdf, Gll^Fdw, Gll^Fdw, Gll^Fdw, Gll^Fmf, Gll^Fmf, Gll^Fmf, Gll^Fmf, Gll^Fdf, Gd, Gd, Gd, Gll^Fdf, Gll^Fmf, Gll^Fdf, Gd, Gd, Gll^Fdw, Gd, Gll^Fdf, Gs, Gs^Fms, Gll, Rb, Gs^Fms, Gs^Fms, Gs^Fms, Gll^Fdf, Gll^Fdf, Gs, Gg, Gs^Fms
Gll^Fdw, Gll^Fdw, Gll^Fdw, Gll^Fdf, Gll^Fdf, Gll^Fdf, Gll^Fdw, Gll, Gll^Fdw, Rb, Rb, Rb, Gll, Gll^Fdf, Gll^Fdf, Gll, Gll, Gs^Vc, Gs, Gll^Fdf, Gll^Fdf, Gll^Fdf, Gd, Gll^Fdw, Gll^Fdw, Gg, Gd, Gs, Gd, Gd, Gll^Fdf, Gll, Rb, Gs, Gll^Fdf, Gd, Gll^Fdw, Gg, Gll^Fdw, Gs^Fms, Gs, Gs, Gll, Gs, Gg, Gs^Fms, Gs^Fms, Gs^Fms, Gs^Fms, Gll^Fdf, Gll^Fdf, Gg
Gll^Fdw, Gll^Fdw, Gll^Fdw, Gs, Gll^Fdf, Gll^Fmf, Gll^Fmf, Gll, Gll, Rb, Rb, Rb, Rb, Gll^Fdf, Gll^Fdf, Gll^Fdf, Gll^Fdf, Gll^Fdf, Gll^Fmf, Gs, Gs, Gll^Fdf, Gd, Gll^Fmf, Gd, Gd, Gll^Fdf, Gs, Gll^Fmf, Gll^Fmf, Gll^Fdf, Gd, Rb, Gll^Fmf, Gs, Gll^Fdf, Gll^Fmf, Gll^Fdw, Gll^Fdw, Gs^Fms, Gs, Gll^Fdf, Gll^Fdf, Gs, Gg, Gg, Re, Gs^Fms, Gs^Fms, Gs^Fms, Gs^Fms, Gg
Gll^Fdw, Gll^Fdw, Gll^Fdw, Gll^Fdf, Gll^Fdf, Gs, Gll^Fmf, Gll, Rb, Rb, Gll, Gll^Fdw, Gll^Fdw, Gll^Fdf, Gll^Fdf, Gll^Fdf, Gll^Fdf, Gs, Gs, Gll^Fmf, Gs, Gll^Fdf, Gd, Gd, Gll^Fdf, Gll^Fdf, Gll^Fdf, Gg, Gs, Gll^Fmf, Gll^Fmf, Gll^Fmf, Gs, Rb, Gll, Gs, Gll^Fmf, Gll^Fmf, Gg, Gs^Fms, Gs, Gs^Fms, Gs^Fms, Gll, Gll^Fdf, Gg, Gg, Gs^Fds, Gs^Fds, Gs^Fms, Gs^Fms, Gs^Fms
Gll^Fdf, Gll^Fdf, Gll^Fmf, Gll^Fdw, Gll^Fdw, Gs, Gll, Gll, Gll, Gg, Gll^Fdf, Gll^Fdf, Gll^Fdf, Gll^Fdw, Gd, Gll^Fdf, Gll^Fmf, Gll^Fmf, Gll^Fmf, Gll^Fmf, Gs, Rb, Gs, Gd, Gll^Fdf, Gll^Fdf, Gll^Fdf, Gll^Fmf, Gll^Fmf, Gll^Fmf, Gll^Fmf, Gll^Fmf, Gs, Rb, Gll, Gs^Fms, Gs^Fms, Gs, Gs, Gll^Fmf, Gg, Gs^Fms, Gs^Fds, Gll^Fdf, Gs^Fms, Gs^Fms, Gs^Fds, Gs^Fds, Gs^Fds, Gs^Fms, Gs^Fms, Gs^Fms
Gll^Fmf, Gll^Fmf, Gll^Fmf, Gll^Fmf, Gll^Fdf, Gll^Fdw, Gll, Rb, Gll, Gll, Gll, Gd, Gd, Gll^Fdw, Gd, Gll^Fdw, Gll^Fdw, Gll^Fmf, Gd, Gd, Gll^Fmf, Rb, Rb, Gll^Fmf, Gll^Fdf, Gll^Fdf, Gs^Fms, Gll^Fdf, Gs^Fms, Gll^Fmf, Gll^Fmf, Gg, Gs, Gll^Fdf, Gll^Fdf, Gs^Fds, Gll, Gs^Fms, Gs^Fms, Gs, Re, Gs^Fms, Gs^Fms, Gll^Fdf, Gll^Fdf, Gs^Fms, Gs^Fms, Gg, Gg, Gs^Fms, Gs^Fms, Gs^Fds
Gll^Fmf, Gll^Fmf, Gll^Fmf, Gll^Fmf, Gll, Gll, Rb, Gs, Gll, Gll, Gll, Gs^Vc, Gd, Gll^Fdf, Gd, Gll^Fdw, Gd, Gll^Fdw, Gll^Fmf, Gll^Fmf, Gll^Fmf, Gll^Fmf, Gs, Rb, Gs, Gs^Fms, Gs^Fms, Gs^Fms, Gs^Fms, Gs^Fms, Gg, Gs^Fms, Gs^Fms, Gll^Fmf, Gll^Fmf, Gll^Fdf, Gs^Fds, Gll, Gg, Gs^Fms, Gs^Fms, Gg, Gs^Fds, Gs^Fms, Gs^Fms, Gs^Fms, Gs^Fms, Gg, Gg, Gs^Fms, Gs^Fms, Gs^Fms
Gll^Fdf, Gll^Fmf, Gll, Gll, Rb, Rb, Gg, Gll, Rb, Gll, Gll, Gll^Fdf, Gd, Gll, Gs, Gd, Gll^Fmf, Gll^Fmf, Gll^Fmf, Gll^Fmf, Gll^Fmf, Gll^Fmf, Gll^Fmf, Gs, Gs, Gs^Fms, Ce, Gs^Fms, Gs^Fms, Gs, Gs, Gg, Gs^Fms, Gll^Fmf, Gll^Fmf, Gll^Fmf, Gs^Fds, Gs^Fds, Gg, Gs^Fms, Gs^Fms, Gs^Fds, Gg, Gs^Fds, Gs^Fds, Gs^Fms, Gs^Fms, Gs^Fms, Gs^Fms, Gs^Fms, Gs^Fms, Gs^Fms
Gll^Fdf, Gll^Fmf, Gll, Gll, Gll, Gll, Gg, Gll, Gg, Rb, Rb, Gd, Gll^Fmf, Gg, Gll^Fdf, Gll, Gs, Gll^Fmf, Gll^Fmf, Gll^Fmf, Gll^Fmf, Gll^Fdf, Gll^Fdf, Gll^Fmf, Gll^Fmf, Ce, Ce, 5 Ke, Ce, Gll^Fdf, Gll^Fdf, Gg, Gg, Gs^Fms, Gs^Fms, Gg, Gll^Fmf, Re, Gs^Fds, Gg, Gs^Fds, Gs^Fds, Gs^Fds, Gg, Gs^Fms, Gs^Fds, Gs^Fds, Gs^Fds, Gs^Fms, Gs^Fms, Gs^Fms, Gs^Fms
Gll^Fdf, Gll, Gll, Gll, Gll, Gll^Fdf, Gg, Gll^Fmf, Gg, Gg, Rb, Gd, Gll^Fmf, Gll^Fmf, Gll^Fdf, Gll^Fdf, Gll^Fdf, Gll, Gs^Fms, Gs^Fms, Gs^Fms, Gll^Fmf, Gll^Fdf, Gg, Gg, Gll^Fmf, Ce, Ce, Gs^Fms, Gll^Fmf, Gll^Fmf, Gs^Fds, Gs^Vc, Gs, Re, Gll^Fmf, Gll^Fmf, Gll^Fmf, Gs^Fms, Gs^Fds, Gg, Gs^Fds, Gll, Gg, Gs^Fms, Gs^Fms, Gll, Gs, Gs, Gs^Fms, Gs^Fms, Gs^Fms
Gll^Fdf, Gll^Fdf, Gll^Fmf, Gll, Gll^Fdf, Gll^Fdf, Gg, Gd, Gll, Gll, Gll, Gd, Gll, Gs^Fms, Gll, Gs^Fms, Gg, Gll^Fdf, Gs, Gs^Fms, Gll, Gs^Fms, Gs^Fms, Gll^Fdf, Gs^Vc, Gll^Fmf, Gg, Gs^Fms, Gs, Gs^Fms, Gg, Gs^Fds, Gs^Fds, Gg, Gs^Fms, Gs^Fms, Gs^Fms, Gll, Gs^Fms, Gs^Fms, Gg, Gll, Gs^Fms, Gll, Gs^Fms, Gs^Fms, Gs^Fms, Gll, Gs^Fds, Gs, Gs, Gs^Fds
Gll^Fmf, Gll^Fdf, Gll^Fmf, Gd, Gs, Gd, Gll^Fdf, Gd, Gll^Fmf, Gll, Gll, Gll, Gll, Gg, Rb, Gll, Gll, Gll, Gll, Gll, Gll, Gll, Gll, Gs^Fms, Gs^Fms, Gs, Re, Gll^Fdf, Gll^Fdf, Gs^Fms, Gs^Fms, Gg, Gg, Gll, Gg, Gs^Fms, Gll, Gs^Fms, Gll, Gll, Gs^Fms, Gs^Vc, Gs^Fms, Gs, Gs^Fds, Gs^Fms, Ce, Gs^Fms, Gs^Fds, Gs^Fds, Gs^Fds, Gs^Fds
Gll^Fmf, Gll^Fmf, Gd, Gd, Gll^Fdf, Gs, Gll^Fdf, Gs^Vc, Gg, Gll^Fmf, Gll^Fmf, Gll, Gll, Gg, Gg, Rb, Gs, Gll, Gs, Gll, Rb, Gll, Gg, Gll, Gll, Gs^Fms, Gll, Gg, Gll, Gs^Fms, Gll, Gll, Gll, Gll, Gs, Gll, Gll, Gll, Gll, Gll, Gll, Gg, Gll, Gs, Ce, Ce, 6 Ke, Ce, Gs^Fds, Gs^Fds, Gs^Fds, Gs^Fds
Gll^Fmf, Gll^Fmf, Gll^Fmf, Gd, Gll^Fmf, Gs, Gs, Gll^Fdf, Gll^Fdf, Gll^Fmf, Gll^Fmf, Gs^Fms, Gs^Fms, Gll, Gll, Gll, Gll, Gs, Gs^Fms, Gll, Gll, Rb, Gg, Gll, Gll, Gll, Gll, Gs, Gs, Gg, Gg, Gs, Gs, Gs, Gll, Gll, Gll, Rb, Gs, Rb, Gs, Gg, Gll, Gll, Gll, Gll, Gll, Ce, Gll, Gs^Fds, Gs^Fds, Gs^Fds
Gll^Fmf, Gll^Fmf, Gll^Fmf, Gd, Gd, Gll^Fmf, Gs^Fms, Gll^Fdf, Gg, Gg, Gll^Fmf, Gll^Fmf, Gll^Fmf, Gs^Fms, Gs^Fms, Gll^Fdf, Gll^Fdf, Gs^Fms, Gs^Fms, Gll^Fdf, Gll^Fdf, Gs^Fms, Gg, Gll, Gll^Fmf, Gll, Gll, Gll, Gll, Gll, Gg, Gll, Gs^Fds, Gll, Gs^Fms, Gll, Gs^Fms, Gll, Gll, Gll, Gll, Gg, Gs, Gll, Gll, Gs, Gs, Gg, Gg, Gg, Gll, Gs^Fds
Gll^Fmf, Gll^Fmf, Gs^Fms, Gs, Gs, Gll^Fmf, Gll^Fmf, Gs^Fms, Gs^Fms, Gll^Fmf, Gll^Fmf, Gll^Fmf, Gs^Fms, Gs^Fms, Gs^Fms, Gg, Gll^Fdf, Gll^Fdf, Re, Gll, Gs^Fms, Gll^Fdf, Gs^Fms, Gg, Gll^Fmf, Gll^Fmf, Gs^Fms, Re, Gll, Gs^Fds, Gll, Gs, Gs, Gs^Fms, Gs^Fds, Gll, Gs^Fds, Gs^Fms, Gll, Gll, Gll, Gll, Re, Re, Gs^Fds, Gs^Fds, Gll, Gg, Gll, Gs, Gll, Gll
Gll^Fmf, Gll^Fmf, Gs^Fms, Gs^Fms, Ce, Gll, Gll^Fdf, Gll^Fdf, Gll^Fdf, Gs, Gg, Gs^Fms, Gs^Fms, Gs^Fms, Gs^Fms, Gs^Fms, Gll^Fdf, Gll^Fdf, Gg, Gll^Fdf, Gs^Fms, Gs^Fms, Gs^Fms, Gg^Ve, Gs^Fms, Gg, Gs^Fms, Gs^Fms, Gs^Fds, Gs^Fds, Gll, Gll, Gll, Gll, Gs^Fds, Gs^Fds, Gll, Gs^Fds, Gll, Gll, Gll, Gs^Fds, Gs^Fds, Gll, Gs^Fds, Gs^Fds, Gs^Fds, Gll, Gs^Fds, Gll, Gs, Gll
Gll^Fmf, Gll^Fmf, Gll^Fmf, Ce, 4 Ke, Ce, Ce, Gll^Fdf, Gll^Fdf, Gll^Fdf, Gs, Gs^Fms, Gs^Fms, Gs^Fms, Gs^Fms, Gs, Gs, Gll^Fdf, Gs^Fds, Gs^Fds, Gg, Gll, Gs^Fms, Gs^Fms, Re, Gs^Fms, Gll, Gs^Fms, Gs^Fds, Gs^Fds, Gs^Fds, Gs^Fms, Re, Gs, Gg^Ve, Gs^Fds, Gll, Gll, Gg, Gg, Gll, Re, Gs^Fds, Gs^Fds, Gs^Fds, Gg^Ve, Gs^Fds, Gs^Fds, Gs^Fds, Gs^Fds, Gs^Fds, Gs
Gs^Fms, Gs^Fms, Gs^Fms, Ce, Ce, Ce, Ce, Ce, Gll^Fdf, Gs^Fms, Gs^Fms, Gg, Gg, Re, Gs^Fms, Gll, Gs^Fms, Gll^Fdf, Gs, Gs^Fds, Gs^Fds, Gs^Fms, Gll, Gs^Fms, Gll, Gll, Gll, Gs^Fms, Gs^Fms, Gs^Fds, Gs^Fms, Gs^Fms, Gs^Fms, Re, Gll, Gs^Fds, Gg, Gg, Gll, Gll, Gll, Gs^Fds, Gs^Fds, Gs^Fds, Gs^Fds, Gll, Gs, Gll, Gs^Fds, Gs^Fds, Gs^Fds, Gs^Fds
Gs, Gs^Fms, Gll^Fdf, Gs^Fms, Gg^Ve, Gll^Fdf, Gll^Fdf, Gs^Fds, Gs^Fds, Gll^Fdf, Gs^Fms, Gg, Gg, Gll, Gll^Fmf, Gs^Fms, Gg, Gs^Fms, Gs^Fds, Gll, Gs, Gs^Fms, Re, Gg, Gll, Gg, Gs^Fds, Gs^Fds, Gs^Fds, Gs^Fms, Gs^Fms, Gs^Fms, Gs^Fms, Gs^Fms, Gs^Fms, Gll, Gll, Gs, Gll, Gll, Gs^Fds, Gs^Fds, Gll, Gs^Fds, Gs^Fds, Gs^Fds, Gs^Fds, Gll, Gs^Fds, Gs^Fds, Gs^Fds, Gs^Fds
Gll^Fdf, Gs, Gll^Fdf, Gll^Fdf, Gll^Fdf, Gs^Fms, Gs^Fms, Gll, Gs^Fms, Re, Gll, Gs^Fms, Gs^Fms, Gg, Gs^Fms, Gll^Fmf, Gs^Fms, Gs^Fms, Gg, Gs^Fds, Gs^Fds, Gll, Gs^Fds, Gll, Gll, Gs^Fds, Gs^Fds, Gs^Fds, Gs^Fms, Gs^Fms, Gs^Fms, Gs^Fms, Gs^Fds, Gs^Fds, Gs^Fms, Gll, Gs, Gs, Gll, Gll, Gs^Fds, Gs^Fds, Gs^Fds, Gs^Fds, Gll, Gs^Fds, Gll, Gll, Gs^Fds, Gs^Fds, Gs^Fds, Re
Gll^Fdf, Gg, Gs, Gll^Fdf, Gs^Fms, Gs^Fms, Re, Gs^Fds, Gs^Fds, Gs^Fds, Gs^Fds, Gs^Fms, Gs^Fms, Gs^Fds, Gg^Ve, Gll, Gs^Fms, Gs^Fms, Gs^Fds, Gs^Fds, Gll, Gs^Fms, Gs^Fds, Gs^Fds, Gs^Fds, Gll, Gll, Gs^Fds, Gll, Gs^Fms, Gs^Fms, Gs^Fms, Gs^Fds, Gs^Fds, Gg, Gll, Gs, Gll, Gs, Gs^Fds, Gs^Fds, Gs^Fds, Gs^Fds, Gs^Fds, Gs^Fds, Gs^Fds, Gs^Fds, Gs, Gll, Gs^Fds, Re, Re
Gs^Fms, Gll^Fdf, Gll^Fdf, Gll, Gll^Fmf, Gs^Fms, Gg, Gll, Gs^Fds, Gs^Fds, Gg, Gs^Fds, Gs, Gs^Fms, Gs^Fds, Gs^Fds, Gll, Gs^Fds, Gll, Gs^Fms, Gs^Fms, Re, Gg, Gs^Fds, Gs^Fds, Gg^Ve, Gll, Gll, Gs^Fds, Gll, Gll, Gs^Fds, Gll, Gll, Gll, Gg, Gll, Gll, Gs, Re, Gll, Gs^Fds, Gs^Fds, Gs^Fds, Gs^Fds, Gs^Fds, Gs^Fds, Gs, Gs^Fds, Gs^Fds, Gs^Fds, Gs^Fds
Gs^Fms, Gs^Fms, Gs^Fms, Gll, Re, Re, Gs^Fds, Gll^Fmf, Gs^Fds, Gll, Cv, Gll, Gs, Gs^Fms, Gs^Fds, Gs^Fds, Gll, Gs^Fds, Gll, Gs^Fds, Gs^Fms, Gs^Fms, Gs^Fms, Gs^Fds, Gll, Gs^Fds, Gll, Gs^Fds, Gs, Gg, Gg, Gs, Gll, Gll, Gll, Gll, Gll, Gs^Fds, Gs^Fds, Gs^Fds, Gs, Gll, Gll, Gs^Fds, Gs^Fds, Gs^Fds, Gs, Gs, Gs, Gs, Gs, Gs^Fds
Gs^Fms, Gs^Fms, Gs^Fms, Gs^Fds, Re, Gg, Gs^Fds, Gs^Fds, Gs^Fds, Gs^Fds, Cv, 3 Kv, Cv, Cv, Gs, Gs^Fds, Gs^Fms, Gs^Fms, Gs^Fms, Re, Gs^Fms, Gs^Fms, Gll, Gll, Gg, Gll, Gs, Gs, Gll, Gs, Gll, Gll, Gll, Gll, Gs^Fds, Gs^Fds, Gs^Fds, Gs^Fds, Gg^Ve, Gs^Fds, Gll, Gs^Fds, Gll, Gs^Fds, Gs^Fds, Gs^Fds, Gs^Fds, Gll, Gs^Fds, Gs^Fds, Gs^Fds, Gs
Gs^Fms, Gs^Fms, Gs^Fds, Gll, Gs^Fds, Re, Gg, Gs^Fds, Gs^Fds, Gs^Fds, Gs, Cv, Gs^Fms, Gll, Gg, Gs^Fms, Gll, Re, Gll, Gll, Gll, Gll, Gs, Gg, Gll, Gs, Gll, Gll, Gll, Gll, Gs^Fds, Gs, Gs^Fds, Gs^Fds, Gs^Fds, Gs^Fds, Gs^Fds, Gs^Fds, Gs^Fds, Gll, Gs^Fds, Gs^Fds, Gs^Fds, Gs^Fds, Gs^Fds, Gs^Fds, Re, Gll, Gs^Fds, Gs^Fds, Ww, Gs^Fds
Gs^Fms, Gs^Fms, Gs^Fds, Gs^Fds, Gll, Gg^Ve, Gg, Gg, Gs^Fds, Gs^Fds, Gs^Fds, Gs, Gll, Gll, Gg, Gs^Fms, Gll, Gll, Gll, Gll, Gll, Gll, Gll, Gll, Gs^Fds, Gll, Gll, Gll, Cv, Cv, Re, Gs, Gll, Gs^Fds, Gs^Fds, Gs^Fds, Gs^Fds, Gs^Fds, Gs, Gs^Fds, Cv, Gs^Fds, Cv, Gs, Gs^Fds, Gs^Fds, Gs^Fds, Gll, Ww, Ww, Wwr, Gs^Fds
Gs^Fms, Gs^Fms, Gs^Fds, Gs^Fds, Gs^Fds, Gs^Fds, Gg, Gs^Fds, Gll, Gg, Gs, Gll, Gs, Gg, Gll, Gg, Wwf, Gll, Wwf, Gll, Gll, Gll, Gll, Gll, Gs^Fds, Gs^Fds, Gll, Gll, Cv, Cv, Cv, Gs^Fds, Gs^Fds, Gs^Fds, Gs^Fds, Gs^Fds, Gs^Fds, Gs^Fds, Gll, Gs^Fds, Gs^Fds, Cv, Gs^Fds, Gs, Ww, Wwr, Wwr, Wwr, Wo, Wwr, Ww, Ww
Gs^Fms, Gs^Fms, Gs^Fms, Gs^Fds, Gs^Fds, Gs^Fds, Gll, Gll, Gg, Gs, Gll, Gs, Gll, Gll, Ww^Ewf, Ww, Ww, Wwf^Bw|, Ww, Wwf, Ww, Gll, Gs^Fds, Gll, Gll, Gs^Fds, Gll, Gll, Gll, 2 Kv, Gs^Fds, Gs^Fds, Gs^Fds, Gs^Fds, Gll, Gs^Fds, Gll, Gs, Gs^Fds, Gs^Fds, Gll, Gs^Fds, Ww, Ww, Ww, Ww, Ww, Wo, Wo, Wo, Wo, Wo
Gs^Fms, Gs^Fms, Gs^Fds, Gs^Fms, Gs^Fms, Gll, Gg, Gg, Gll, Gll, Wwf, Wwf, Ww^Ewf, Gs^Fds, Gs^Fds, Ww, Ww, Ww^Bw|, Wo, Ww, Ww, Ww, Wwr, Gs^Fds, Ww^Ewf, Gll, Gll, Gll, Gll, Gs, Gs^Fds, Gs^Fds, Gs^Fds, Gs^Fds, Gs^Fds, Gll, Gll, Gll, Gs^Fds, Gs^Fds, Ww, Wwr, Ww, Ww, Ww, Ww, Ww, Ww, Wo, Wo, Wo, Wo
Gs^Fds, Gs^Fds, Gs^Fds, Gs^Fds, Gs^Fms, Gll, Gs, Gll, Gs^Fms, Gs^Fms, Ww, Ww, Ww, Wo, Wo, Wo, Wo, Wo^Bw|, Wo, Wo, Wo, Ww, Wo, Wwr, Ww, Wwf, Wwf, Gll, Gll, Gs^Fds, Gll, Gg^Ve, Gs^Fds, Gll, Gs^Fds, Gll, Gs^Fds, Gs, Ww, Ww, Ww, Ww, Wo, Wo, Wo, Ww, Wo, Wo, Wo, Wo, Wo, Wo
Gs^Fds, Gs^Fds, Gs^Fds, Gll, Gs^Fds, Gll, Gs, Gll, Gs^Fms, Gs^Fms, Ww, Ww, Wo, Wo, Wo, Wo, Wo, Wo^Bw|, Wo, Wo, Wo, Wo, Wo, Wo, Ww, Ww, Ww, Gll, Gll, Gll, Gs^Fds, Gs, Gs, Gs^Fds, Gs^Fds, Gll, Wwf, Wwf^Bw\, Ww^Bw\, Ww, Wo, Wo, Wo, Wo, Wo, Wo, Ww, Wo, Wo, Wo, Wo, Wo
Gs^Fds, Gs^Fds, Gs^Fds, Gs^Fds, Gll, Gll, Gs, Gll, Gll, Ww^Ewf, Ww, Ww, Wo, Wo, Wwr, Wwr, Gg, Wo^Bw|, Wwr, Wo, Wo, Wo, Wo, Wo, Wo, Ww, Ww, Gs^Fds, Ww, Ww^Ewf, Wwf, Gs^Fds, Gs^Fds, Gs, Gs, Wwr, Ww, Ww, Wo, Wo^Bw\, Wo^Bw\, Wo, Wo, Wo, Wo, Ww, Gs^Fds, Wo, Wo, Wo, Wo, Wo
Gs^Fds, Gs^Fds, Gs^Fds, Gs^Fds, Cv, Gs, Gll, Gll, Gll, Ww, Wwr, Wo, Wo, Wo, Wwr, Gg, Gg^Ve, Gg, Gs, Wwf, Gs, Wo, Wo, Wo, Wo, Wo, Wo, Wo, Wo, Ww, Ww, Wwf, Gs, Gs^Fds, Gs, Ww, Wo, Wo, Wo, Wo, Wo, Wo^Bw\, Wo^Bw\, Wo, Wwr, Gs^Fds, Gs, Gs^Fds, Gg, Wo, Wo, Wo
Gs^Fds, Gs^Fds, Gs^Fds, Gs^Fds, Cv, Gs, Gs, Gll, Gll, Wwf, Wwr, Wo, Wo, Wo, Wo, Gg, Gg, Gg, Gs, Gs, Gs, Gg, Gg, Wo, Wo, Wo, Wo, Wo, Wo, Wo, Wo, Ww, Wwr, Gs, Ww, Wo, Wo, Wo, Wo, Wo, Wo, Wo, Wwr, Wo^Bw\, Gg, Gg, Gg^Fet, Gs, Gg, Ww, Wo, Wo
Gs^Fds, Gs^Fds, Gs^Fds, Gs^Fds, Gs^Fms, Cv, Gs, Gll, Gll, Wwf, Ww, Ww, Wo, Wo, Wo, Gg, Gs^Fds, Gs^Fds, Gs, Gs, Gg^Fet, Gs, Gs, Gs^Fds, Gs^Fds, Wwr, Wwr, Wo, Wwf, Wo, Wo, Wo, Wo, Wwr, Wo, Wo, Wo, Wo, Wo, Wo, Wo, Wwr, Gs^Fds, Gg, Gg^Ve, Gs, Gg, Gg, Ww, Ww, Wo, Wo
Gs^Fds, Gs^Fds, Gs^Fds, Gg^Ve, Gs, Gs^Fms, Gs^Fms, Gll, Gll, Wwf, Ww, Ww, Ww, Wo, Wo, Wo, Gs^Fds, Gs^Fds, Gs, Gd, Gd, Gs, Gd, Gs, Gs, Gs^Fds, Gs^Fds, Wwf, Gs^Fds, Gs^Fds, Gg, Wo, Wo, Wo, Wo, Wo, Wo, Wo, Wo, Wo, Wo, Wo, Ww, Gg, Ww, Gg, Gs^Fds, Gs^Fds, Ww, Ww, Wo, Wo
Gs^Fds, Gs^Fds, Gs^Fds, Gs, Gs, Gs, Gs, Gll, Gll, Ww, Ww, Ww, Ww, Ww, Wo, Wo, Wo, Gs^Fds, Gg, Gs, Gg, Gd, Gd, Gs, Gs, Gs^Fds, Gs^Fds, Gs^Fds, Gg, Gg, Gg, Wwf, Wo, Wo, Wo, Wo, Wo, Wo, Wo, Wo, Wo, Wo, Ww, Ww, Ww, Ww, Ww, Ww, Wo, Ww, Ww, Wo
