Xu, Ur, Ur, Ur, Urb, Uh, Uu^Vu, Xu, Xoa, Xoa, Mm^Xm, Hh, Mm, Mm^Xm, Mm, Ur, Ur, Mm, Hh, Wo, Wo, Mm, Mm, Mm^Xm, Mm^Xm, Mm, Mm, Hh, Hh, Ww, Ww, Hh, Hh, Mm, Mm^Xm, Mm
Xu, Xu, Xu, Xoc, Xoc, Urb^Edb, Ur, Xu, Xoa, Mm^Xm, Mm^Xm, Mm^Xm, Mm^Xm, Mm, Hh^Vhh, Ur, Mm, Hh, Mm, Hh, Ww, Wo, Wo, Mm, Mm, Mm^Xm, Mm, Mm, Mm, Hh, Wo, Ww, Hh, Mm, Mm, Mm
Xu, Tb^Tf, Tb, Xu, Xu, Xoc, Urb, Xu, Xoa, Xoa, Mm^Xm, Mm, Mm, Hh, Mm, Mm^Xm, Mm, Hh, Hh, Hh, Ww, Ww, Wo, Wo, Ww, Mm, Hh, Mm, Mm, Mm, Mm, Ww, Hh, Mm, Mm, Mm
Xu, Xu, Xu, Uue^Em, Ur^Edb, Xu, Urb^Edb, Xoc, Xoa, Mm^Xm, Mm, Mm, Rp, Rp, Mm, Mm, Hh, Hh, Ww, Ww, Mm, Mm^Xm, Mm, Wo, Wo, Ww, Ww, Wo, Wo, Mm, Hh, Wo, Wo, Hh, Wo, Wo
Mm^Xm, Mm^Xm, Xu, Uh, Uu^Vu, Ur, Rr^Pr/o, Xoc, Xoa, Mm^Xm, Hh, Hh, Rp, Rp, Hh, Hh, Hh, Hh, Ww^Es, Hh, Hh, Mm, Mm, Hh, Hh, Ww, Hh, Ww, Mm, Wo, Ww, Hh, Ww, Mm, Ww, Ww
Wo, Mm^Xm, Mm^Xm, Xu, Xoc, Rr^Pr/, Uh^Dr, Ur, Rb, Uh, Re, Hh, Hh, Hh, Rp, Hh, Hh, Hh, Hh, Hh, Hh, Rp, Mm, Hh, Hh, Ww, Hh, Mm, Mm, Mm^Xm, Mm^Xm, Ww, Hh, Ww, Hh, Hh
Wo, Mm, Mm^Xm, Xue, Xue, Xoc, Xue, Ur, Rb, Re, Gd^Edb, Re, Gg, Rp, Rp, Gg, Gg, Hh, Gg, Hh, Gg, Rp, Hh, Hh, Hh, Ww^Es, Hh, Mm, Hh, Mm, Mm, Mm^Xm, Mm, Hh, Mm, Mm
Wo, Wo, Wo, Mm^Xm, Mm^Xm, Xue, Mm^Xm, Rb, Ur, Ur^Ecf, Rp, Re, Rp, Gg, Gg, Gg^Es, Gg^Efm, Gg, Gg, Gg, Gg, Gg^Es, Gg, Gg, Gg, Hh, Hh, Hh, Hh, Mm, Mm, Mm, Hh, Mm, Hh, Hh
Wo, Wo, Ww, Hh, Hh, Mm^Xm, Mm, Mm, Hh, Ur, Rp, Re^Es, Gg, Rp, Re^Es, Gg, Gg, Gg, Gg, Gg, Gg, Gg, Gg, Gg, Gg^Efm, Gg, Gg, Gg, Gg, Hh, Hh, Hh, Hh, Hh^Vhh, Hh, Hh
Wo, Wo, Wwr, Ww, Hh, Mm, Hh, Hh, Gg, Rp, Rp, Gg^Efm, Gg^Efm, Gg^Efm, Gg^Efm, Rp, Rp, Gg, Gg, Gg, Gs^Vc, Gg, Gg, Gg^Efm, Gg, Gg^Efm, Gg^Efm, Gg, Gg, Gs^Fds, Gs^Fds, Gs^Fds, Gs^Fds, Hh, Gs^Fds, Hh
Ww, Ww, Ww, Ww, Hh, Hh, Gg^Efm, Gg, Rp, Gg, Gg, Gg^Efm, Gg, Gg^Efm, Gg^Efm, Gg, Gg, Gg^Es, Gg, Gg, Gg, Gg^Efm, Gg^Efm, Gg, Gg, Gg, Gg, Gg, Gg, Gs^Fds, Gs^Fds, Gs^Fds, Gs^Fds, Gs^Fds, Gs^Fds, Gs^Fds
Ss, Ss, Sm, Wwr, Hh, Gg, Gg^Efm, Gg, Re^Es, Gg, Gs, Gg, Gs, Gg, Gg^Efm, Gg, Gg, Gs, Gs, Gg, Gg, Gg^Efm, Gg^Efm, Gg, Gg, Gg, Gg, Gg, Gg, Gg, Gg, Gg, Gs^Fds, Gs^Fds, Gs^Fds, Gs^Fds
Ss^Em, Ss^Em, Ss, Ww, Sm, Gg, Gg, Gg, Gg, Rp, Rp, Gs, Gs, Gs, Gg, Gg, Rp, Gg, Gs, Gg, Gg, Gg, Gg, Gg, Gg, Gg, Gg, Gg, Gg, Gg, Gg, Gs^Fds, Gs^Fds, Gs^Fds, Gg, Gs^Fds
Ww^Ewf, Ww, Ss, Ss, Sm, Gg, Gg, Gs, Gs, Rp, Rp, Gg, Gg, Gg, Gs, Gg, Gg^Es, Gg, Gg, Gg, Gs^Fds, Gg, Gs^Fds, Gg, Gg, Gg, Gg, Gg, Gg^Efm, Gg, Gg, Gg, Gg, Gs^Fds, Gg, Gg
Sm, Ww, Ss^Em, Ww, Sm, Gg, Gg, Gs, Gg, Gs, Re, Gg^Es, Gg, Gs, Gs, Gs, Gg, Gg, Gg, Gg, Gs^Fds, Gs^Fds, Gs^Fds, Gs^Fds, Gg, Gg, Gg, Gg, Gg^Efm, Gg^Efm, Gg^Efm, Gg, Gg, Gg, Gg, Gg
Sm, Ss^Vhs, Ss^Em, Ww, Wwr^Em, Rp^Es, Re^Es, Gg, Gs, Re, Gs^Eff, Gg, Rp, Gg, Gg, Gs, Gg, Gs^Fds, Gs^Fds, Gg, Gs^Fds, Gs^Fds, Gs^Fds, Gs^Fds, Gs^Fds, Gg, Gs^Fds, Gg^Efm, Gg, Gg^Efm, Gg, Gg, Gg, Gg, Gg, Gg
Ww, Ww, Sm^Em, Sm^Em, Rp^Es, Rp^Es, Re, Re^Es, Gs, Gs^Eff, Gs^Es, Gs^Eff, Gs^Eff, Gs, Gs, Gg, Rp, Gs^Fds, Gs^Fds, Gs^Fds, Gs^Fds, Gs^Fds, Gs^Fds, Gs^Fds, Gs^Fds, Gg, Cv, Gs^Fds, Gs^Fds, Gg, Gg, Gg, Gs^Fds, Gs^Fds, Gs^Fds, Gg
Gs^Fds, Ss^Em, Sm^Em, Tb^Emf, Gg, Rp, Gs^Eff, Re, Re, Gs, Gs^Vl, Gs^Es, Gs, Gs^Eff, Gs^Eff, Gg^Eff, Gg^Eff, Gs^Fds, Gs^Fds, Gs^Fds, Gs^Fds, Gs^Fds, Gs^Fds, Gs^Fds, Gg, Gg, Gs^Fds, Gs^Fds, Gs^Fds, Gg, Gg, Gs^Fds, Gs^Fds, Gs^Fds, Gs^Fds, Gs^Fds
Gs^Fds, Gs^Fds, Sm^Em, Gll^Em, Gg, Gs^Eff, Gs^Eff, Gs, Gs^Vl, Rb^Ebn, Gs^Vl, Gs, Gs^Eff, Gs, Gs^Gvs, Gg^Gvs, Gg^Gvs, Gg^Eff, Gg^Eff, Gs^Fds, Gg, Gs^Fds, Gg, Gg, Gs, Gg, Ww, Ss, Ss, Gg, Gg, Gg^Es, Gs^Fds, Gs^Fds, Gs^Fds, Gs^Fds
Ss, Ss^Em, Gs^Fds, Gll^Em, Gg, Gs, Gs, Gs^Eff, Gs^Eff, Gs^Vl, Gs^Eff, Gs^Eff, Gg^Eff, Gg^Gvs, Gg^Gvs, Gg^Gvs, Gg^Gvs, Gg^Gvs, Gg^Gvs, Gg^Eff, Gg^Eff, Gg, Rp, Gg, Gs, Gs, Ww, Wwr, Ss, Gg^Fet, Gg, Gs^Fds, Gs^Fds, Gg, Gg, Gs^Fds
Gs^Fds, Gs^Fds, Gs^Fds, Gg, Gg, Rp, Rp, Gs, Gg, Gs^Eff, Rp, Gg, Gs, Gg^Eff, Gg^Eff, Gg^Gvs, Gg^Gvs, Gg^Gvs, Gg^Gvs, Gg^Gvs, Gg^Eff, Gg^Eff, Gg, Gs, Gg, Gg, Ss, Ss, Gs^Fds, Ss^Es, Gs^Fds, Gs^Fds, Gs^Fds, Gs^Fds, Gg, Gs^Fds
Gs^Fds, Gs^Fds, Gg, Gg, Gs, Rp, Rp, Gs, Gg, Gg, Gg, Gg^Vwm, Gs, Gg, Gg, Gg^Eff, Gg^Eff, Gg^Gvs, Gg^Eff, Gg^Eff, Gs^Fds, Gg, Gs^Fds, Gg, Gg, Gg, Gs^Eqf, Gs^Eqf, Gg^Eqf, Gs^Fds, Gg, Gs^Fds, Cv, Gs^Fds, Gs^Fds, Gs^Fds
Gs, Gg, Rp, Rp, Gs, Rp, Gg, Gg, Gs^Fds, Gs^Fds, Gs^Fds, Gs, Gg^Efm, Gs^Fds, Gs^Fds, Rp, Rp, Gg^Eff, Gs^Fds, Gs^Fds, Gs^Fds, Gs^Fds, Gs^Fds, Gg, Gg, Gg, Gg, Gg, Gs^Fds, Gs^Eqf, Gs^Eqf, Gs^Eqf, Gs^Fds, Gs^Eqf, Gs^Eqf, Gg
Rp, Rp, Rp, Rp, Rp, Gg, Gs, Gg^Efm, Gs^Fds, Gs^Fds, Gs^Fds, Gs^Fds, Gs^Fds, Gs^Fds, Gs^Fds, Rp, Gs, Gs^Fds, Gs^Fds, Gs^Fds, Gs^Fds, Gs^Fds, Gs^Eqf, Gs^Eqf, Gg, Gg, Gs^Fds, Cv, Gs^Fds, Gs^Fds, Gg, Gs^Fds, Gg, Gs^Fds, Gg, Gg^Eqf
Rp, Rp, Gs, Rp, Gg, Gs, Gs, Gg, Gs^Fds, Gs^Fds, Gs^Fds, Gs^Fds, Gs^Fds, Gs^Fds, Gs^Fds, Re, Rp, Gs^Fds, Gg, Gs^Fds, Gs^Eqf, Gs^Eqf, Gs^Fds, Gs^Fds, Gs^Fds, Gg, Gs^Fds, Gs^Fds, Gs^Fds, Gs^Fds, Gs^Fds, Gg^Ve, Gg, Gg, Gs^Fds, Gs^Fds
Rp, Rp, Rp, Gs, Gg, Gg, Gg, Gg, Gg, Gs^Fds, Gs^Fds, Gs^Fds, Gs^Fds, Gs^Fds, Rp, Rp, Rp, Gg, Gs^Eqf, Gs^Eqf, Gs^Fds, Gg, Gs^Fds, Gs^Fds, Gs^Fds, Gs^Fds, Gs^Fds, Gs^Fds, Gs^Fds, Gs^Fds, Gs^Fds, Gg, Gs^Fds, Gs^Fds, Gs^Fds, Gs^Fds
