Gll^Fmf, Wo, Gll^Fmw, Gll^Fmw, Gll^Fmw, Gll^Fmw, Gll^Fmf, Gll^Fmf, Wo, Wo, Wo, Wo, Wo, Gs^Fms, Sm, Gs^Fms, Gs^Fms, Gs^Fms, Rb, Gs^Fms, Gs^Fms, Gs^Fms, Gs^Fms, Gs^Fms, Gs^Fms, Gs^Fms, Gs^Fms, Gs^Fms, Gs^Fms, Gs^Fms, Gs^Fms, Gs^Fms, Gs^Fms, Gs^Fms, Gs^Fms, Gs^Fms, Gs^Fms, Gs^Fms, Gs^Fms, Gs^Fms, Gs^Fms, Gs^Fms, Gs^Fms, Gs^Fms, Gs^Fms, Gs^Fms
Gll^Fmf, Gll^Fmf, Gll^Fmw, Gll^Fmw, Gll^Fmw, Gll^Fmw, Gll^Fmw, Wo, Wo, Wo, Wo, Wo, Wo, Sm, Gs^Fms, Sm, Rb, Gs^Fms, Sm, Rb, Sm, Gs^Fms, Gs^Fms, Gs^Fms, Gs^Fms, Gs^Fms, Sm, Gs^Fms, Gs^Fms, Gs^Fms, Gs^Fms, Gll^Fmf, Gs^Fms, Gll^Fmf, Gll^Fmf, Gs^Fms, Gll^Fmf, Gs^Fms, Gll^Fmf, Gll^Fmf, Gll^Fmf, Gs^Fms, Gll^Fmf, Gs^Fms, Gs^Fms, Gs^Fms
Gll^Fmf, Gll^Fmf, Gll^Fmw, Sm, Rb, Wwf, Wwf, Wo, Wo, Wo, Wo, Wo, Wwf, Wwf, Ww, Sm, Rb, Sm, Gll^Fmw, Gll^Fmw, Gll^Fmf, Gs^Fms, Gll^Fmw, Gs^Fms, Gs^Fms, Gs^Fms, Gll^Fmw, Gll^Fmw, Gs^Fds, Gs^Fds, Gll^Fmw, Gs^Fms, Gll^Fmf, Gs^Fms, Gs^Fds, Gs^Fms, Gs^Fds, Gs^Fms, Gs^Fms, Gs^Fms, Gll^Fmf, Gll^Fmf, Gs^Fms, Gs^Fms, Gll^Fmf, Gs^Fms
Gll^Fmw, Gll^Fmw, Gll^Fmw, Rb, Chs, 4 Khs, Chs, Wwf, Wo, Wo, Wo, Wo, Wo, Wwr, Wwr, Ww, Wwr, Gll^Fmw, Sm, Gll^Fmw, Gll^Fmw, Rb, Rb, Gs^Fds, Gll^Fmw, Gll^Fmw, Gll^Fmf, Gs^Fds, Gs^Fds, Gll^Fmw, Gll^Fmw, Gll^Fmw, Wwf, Gs^Fms, Wwf, Wwf, Ww, Gll^Fmf, Ww, Gll^Fmf, Ww, Gll^Fmf, Gll^Fmf, Gll^Fmf, Gll^Fmf, Gll^Fmf
Gll^Fmw, Gll^Fmw, Ss, Chs, Chs, Chs, Chs, Ss, Ss, Wo, Wo, Wo, Wo, Wwf, Ww^Vm, Ww, Sm, Sm, Gs^Fms, Gs^Fms, Sm, Gll^Fmf, Ww, Ww, Ww, Wwf, Wwf, Wwf, Wwf, Ww, Ww, Ww, Rd, Wwf, Rd, Ww, Gs^Fms, Ww, Gs, Ww, Ce, Wwf, Re, Re, Rd, Rb
Gll^Fmw, Gll^Fmw, Gll^Fmw, Ss, Rb, Rb, Ss, Ss, Ww^Ewl, Sm, Gll^Fmw, Wo, Wo, Wo, Wo, Ww, Ww, Ww, Ww^Ewf, Sm, Sm, Ww, Wo, Wo, Gll^Fdf, Gll^Fmf, Gs^Fds, Gll, Gs^Fds, Rb, Ww, Ww, Gll^Fmw, Gll^Fmw, Gll^Fmw, Gs^Fms, Gg^Ve, Rd, Gs^Fms, Gd, Ce, Ce, 1 Ke, Rd, Gs^Fms, Gll^Fmf
Gll^Fmw, Ww, Gll^Fmw, Wwf, Wwf, Wwf, Ww^Ewl, Ss^Vhs, Sm, Sm, Gll^Fmw, Wo, Wo, Wo, Wo, Wo, Ww, Rb, Rb, Sm, Wo, Wo, Gs^Fms, Rb, Gll^Fmf, Gll^Fmf, Gll^Fdw, Gs^Fms, Sm, Gs^Fds, Gs^Fms, Ww, Gll^Fmf, Gll^Fmf, Rb, Rd, Rd, Gs^Fms, Gll^Fp, Gll, Gll, Ce, Gs^Fds, Gs^Fds, Gs^Fms, Gs^Fms
Ss, Gs^Ft, Gs^Ft, Rb, Gs^Ft, Rb, Gs^Ft, Ss, Sm, Gll^Fmw, Ww, Wo, Wo, Wo, Wo, Wo, Wo, Ww, Ww, Wo, Wwr, Gs^Fms, Gs^Fms, Gs^Fms, Gll^Fmf, Gll^Fp, Gs^Vc, Gs^Fms, Gll^Fmw, Gs^Fds, Gs^Fms, Ww, Ww, Gll^Fmf, Rb, Rd, Gs, Gll^Fmf, Gll^Fp, Gll^Fmf, Gll^Fmf, Ce, Ce, Gs^Fds, Gs^Fds, Gs^Fms
Ss, Sm, Gll^Fmf, Gs^Vht, Gs^Ft, Ur, Rb, Gll^Fmf, Gll^Fmf, Wwf, Wo, Wo, Wo, Wo, Wo, Wo, Wo, Wo, Wo, Wo, Ww, Wwr, Sm, Gll^Fmf, Gll^Fmw, Gll^Fp, Gll^Fp, Gll^Fmw, Gll^Fmw, Gll^Fmw, Gll^Fmw, Gs^Fds, Gll^Fmw, Ww, Wwf, Gll, Ww, Gs, Ww, Gs^Fds, Gs^Fds, Gll^Fmf, Gs^Fds, Gs^Fds, Gll^Fmf, Gs^Fms
Ss, Gs^Ft, Rb, Gs^Ft, Gll^Fmw, Gll^Fmw, Rb, Rb, Gll^Fmf, Ww, Ss, Sm, Ww, Ww, Wo, Wo, Sm, Wo, Wo, Wo, Sm, Rb, Rb, Sm, Sm, Sm, Sm, Sm, Sm, Gll^Fmw, Gll^Fmw, Gll^Fmw, Gll^Fmw, Gll^Fmw, Re, Ww, Gll^Fdf, Ww, Gll^Fmf, Ww, Ww, Gs^Fds, Gs^Fms, Gs^Fds, Gll^Fmf, Gs^Fds
Ss, Ss^Vhs, Rb, Sm, Gll^Fmf, Rb^Emf, Sm, Ss, Rb, Ss, Ww, Ww, Gll^Fmf, Ww, Wo, Wo, Wo, Sm, Wo, Wo, Wo, Wwr, Wwr, Gll^Fmw, Sm, Sm, Gll^Fmf, Gll^Fp, Gll^Fmf, Gll^Fmf, Gs^Fds, Gll^Fmw, Gs^Fds, Gs^Fms, Re, Gd, Gll, Gll^Fmf, Gll^Fmf, Gll^Fmf, Gs^Fms, Gs^Fms, Gll^Fmf, Gll^Fmf, Gll^Fmf, Gll^Fmf
Gll^Fmw, Rb, Gll^Fmf, Gll^Fmf, Wwr, Ur, Wwf, Sm, Rb, Ww, Ss, Ww, Ww^Ewl, Sm, Sm, Wo, Wo, Sm, Wo, Wo, Wo, Sm, Wo, Rb, Wo, Sm, Rb, Gll^Fmf, Gs^Fds, Gll^Fp, Gs^Fds, Gll^Fdf, Gs^Fds, Gll, Gs, Gd, Gd, Gll^Fmf, Gll^Fmf, Gll^Fmf, Gs^Fms, Gll^Fp, Gs^Fds, Gll^Fmf, Gll^Fmf, Gs^Fms
Gll^Fmf, Gll^Fmf, Wwf, Ww, Gs^Ft, Gll^Fmf, Gll^Fmf, Rb, Sm, Ss, Sm, Ww^Ewl, Sm, Sm, Sm, Wo, Wo, Sm, Wo, Ss, Wo, Ww^Vm, Ww, Wo, Wo, Wo, Ww^Bw/, Gll^Fmf, Gs^Fds, Gs^Fms, Gll^Fp, Gll^Fdf, Gll^Fp, Gll, Gll, Gll^Fdf, Gd, Gll^Fmf, Gs^Fms, Gs^Fms, Gll^Fmf, Gll^Fp, Gll^Fp, Gll^Fmf, Gll^Fmf, Gll^Fmf
Ss, Ss, Gs^Ft, Sm, Ss, Wwf, Gll^Fmf, Sm, Ss, Sm, Sm, Sm, Ss, Ss, Ss, Wo, Wo, Wo, Wo, Ss, Wo, Ww, Ww, Gll^Fmw, Gll^Fmw, Gll^Fmw, Ww, Ww, Ww, Ww, Ww, Ww, Ww, Gs^Fms, Gll, Gll^Fmf, Gll^Fmf, Gd, Gs^Fms, Gll^Fmf, Gll^Fmf, Gll^Fp, Gs^Fds, Gs^Fds, Gs^Fds, Gll^Fmf
Ss, Ss, Gll^Fmf, Sm, Rb, Rb, Sm, Sm, Sm, Sm, Ss, Ss, Ss^Vhs, Ss, Sm, Sm, Wo, Wo, Wo, Ss, Wo, Ww, Ww, Chw, Gs^Fms, Gll^Fmf, Gll^Fmf, Rb, Gs^Fds, Wo, Wo, Wo, Gll^Fmf, Ww, Gll, Gs, Gs^Fms, Gd, Gg^Ve, Gll^Fmf, Gll^Fmf, Gll^Fp, Gll^Fp, Gs^Fds, Ww, Ww
Sm, Ss, Sm, Gs^Ft, Rb, Ss, Rb, Sm, Rb, Sm, Ss, Ss, Sm, Sm, Sm, Ss, Wo, Wo, Wo, Ww, Wo, Ww, Chw, Chw, Gll^Fmf, Gll^Fmf, Gs^Fms, Rb, Rb, Gs^Fms, Gll^Fp, Sm, Gll^Fmw, Gll^Fmf, Gll^Fmw, Gs, Re, Rd, Re, Gs^Fms, Gs^Fms, Gll^Fp, Ww, Ww, Gs^Fms, Gs^Fms
Sm, Sm, Gs^Ft, Rb, Ur, Rb, Gs^Ft, Gs^Ft, Ww, Rb, Ss, Sm, Sm, Sm, Ss, Wo, Wo, Ww^Ewl, Wo, Ww, Wo, Chw, 2 Kvr, Gll^Fmf, Gll^Fmf, Gll^Fmw, Gs^Fms, Rb, Gll^Fmw, Gs^Fms, Gll^Fmw, Gs^Fms, Gll^Fdf, Gll^Fmw, Gs^Fds, Re, Rd, Rd, Gs, Gll, Gll^Fmw, Wwf, Wwf, Gs^Fms, Gs^Fms, Gs^Fms
Sm, Rb, Rb, Rb, Rb, Gs^Ft, Rb^Emf, Rb, Sm, Rb, Wo, Ss, Wo, Sm, Wo, Wo, Wo, Wo, Wo, Sm, Wo, Chw, Cvr, Cvr, Gs^Fms, Gs^Fms, Gs, Gs, Gll, Gs, Rb, Rb, Rb, Rb, Rb, Gll^Fp, Rd, Gs, Gd, Gll^Fmw, Gs^Fds, Wwf, Gs^Fds, Gs^Fms, Gs^Fms, Gs^Fms
Ss, Rb, Sm, Ss, Ss, Ur, Ww, Ww, Ww, Wo, Sm, Wo, Ww, Wo, Sm, Wo, Wo, Wo, Wo, Ww, Wo, Ww, Gs^Fms, Cvr, Gs^Fms, Gll^Fmw, Gs, Gll, Gs, Gs^Vc, Gll, Gll, Gll^Fmf, Gs, Gs, Rd, Gd, Gd, Gll^Fmf, Gll^Fdf, Ww, Ww, Gll^Fmw, Gll^Fmw, Gs^Fms, Gs^Fms
Ss, Rb, Rb, Sm, Ss, Wwf, Wwf, Gs^Ft, Ur, Rb, Rb, Sm, Ss, Wwr, Rb, Ww, Wo, Wo, Wo, Ww, Wo, Wwr, Sm, Sm, Wwf, Gll^Fmw, Gs^Fds, Gs^Fds, Rb, Gll, Rb, Gll^Fdf, Rb, Gll^Fmf, Rd, Rd, Gd, Gd, Gs^Fds, Gs^Fds, Ww, Ww, Gll^Fmw, Gll^Fmw, Gll^Fmw, Gs^Fms
Sm, Ss, Wwf, Ss, Sm, Ss, Sm, Wwf, Ur, Sm, Ss, Rb, Ss, Wwr, Rb, Ww, Ww, Wo, Wo, Ww, Wo, Ww, Gs^Fms, Wwf, Gd, Rb, Rd, Rb, Rd, Sm, Gd, Rb, Gll, Rb, Rb, Gd, Gs^Fms, Gs, Gs^Fms, Gs^Fms, Wwf, Gll^Fp, Gs^Vc, Gll^Fmw, Gs^Fms, Gs^Fms
Sm, Wwf, Wwf, Wwf, Ss, Ss, Sm, Sm, Ss, Ss, Sm, Rb, Ss, Ss, Rb, Sm, Wwf, Wwf, Wwf, Wwf, Wwf, Wwf, Gs^Fms, Wwf, Wwf, Rb, Gs, Rd, Ss, Re, Gll, Gll, Gd, Gd, Gs^Fds, Rb, Gll^Fmw, Gs, Sm, Gll^Fmw, Wwf, Gll^Fmw, Gs^Fms, Gs^Fms, Gs^Fms, Gs^Fms
Ss, Wwf, Ss, Rb, Sm, Sm, Rb, Rb, Rb, Ss, Ss, Ss^Vhs, Ss, Rb, Rb, Ss, Sm, Wo, Wo, Wwf, Wwf^Bw/, Wwf^Bw/, Wwf, Gs^Fms, Sm, Gs, Ss, Ss, Gll^Fmw, Gll^Fp, Gll^Fp, Gll^Fdf, Gll^Fmw, Gll^Fdf, Gs^Fms, Rb, Rb, Gs, Sm, Gll^Fp, Wwf, Wwf, Gs^Fms, Gs^Fms, Gs^Fms, Gs^Fms
Ss, Wwf, Ss, Rb, Rb, Rb, Wwf, Sm, Wwr, Sm, Ss, Sm, Ss, Rb, Rb, Sm, Wwf, Wo, Wo^Bw/, Wo^Bw/r, Sm, Wwf, Ww^Vm, Ww, Sm, Ss, Sm, Sm, Sm, Gll^Fmf, Gll^Fmf, Gll^Fp, Gll^Fp, Gs^Fms, Gll^Fp, Re, Gll^Fmw, Rb, Sm, Gll^Fmw, Ww^Ewf, Gll^Fp, Gll^Fmf, Gs^Fms, Gs^Fms, Gs^Fms
Ss, Ss^Vhs, Ss, Rb, Ss, Sm, Wwf, Ww, Ww, Ww, Ww, Sm, Ww, Rb, Wwf, Sm, Wwf^Bw/r, Wo^Bw/r, Wwf, Sm, Ww, Wo, Ww, Wo, Wo, Sm, Sm, Sm, Sm, Sm, Sm, Gll^Fmw, Gll^Fmw, Gll^Fp, Gll^Fmw, Rb, Rb, Gll^Fmw, Ww, Ww^Ewf, Gll^Fmw, Gs^Fds, Gs^Fms, Gll^Fmf, Gll^Fmf, Gs^Fms
Ss, Ss, Rb, Rb, Ss, Ss, Sm, Wwf, Sm, Ww^Ewl, Sm, Ss, Rb^Emf, Ww, Ur, Wwf^Bw/r, Sm, Wwf, Sm, Sm, Wo, Wo, Wo, Ww, Ww, Wo, Wo, Ww, Ww, Sm, Gs^Fms, Sm, Sm, Sm, Sm, Sm, Gll^Fmf, Gll^Fp, Ww^Bw\, Gll, Rb, Gll^Fmw, Sm, Gll^Fmf, Sm, Gll^Fmf
Ss, Ss, Ss, Rb, Sm, Sm, Sm, Ss, Ss, Sm, Rb, Rb, Rb, Rb, Gs^Vht, Sm, Sm, Ss, Ss, Wo, Wo, Ss, Ss, Wo, Ww, Ww, Ww, Wo, Wo, Ww, Ww, Sm, Wwr, Wwr, Wwr, Sm, Sm, Gll^Fdw, Ww, Rb, Gll^Fdf, Gll^Fmf, Rb, Gll^Fmf, Gll^Fmf, Gll^Fmf
Ss, Ss, Ss, Rb, Wwf, Sm, Sm, Sm, Rb, Rb, Rb, Rb, Gs^Ft, Gs^Ft, Gs^Ft, Wwr, Sm, Ss, Wo, Wo, Wo, Wo, Wo, Wo, Wo, Wo, Wo, Ww, Wo, Wo, Wo, Ww, Ww, Wwr, Ww, Wwr, Sm, Ww, Sm, Ss, Gll^Fmw, Gll^Fmw, Gll^Fmf, Rb, Gll^Fmw, Gll^Fmf
Ss, Ss, Sm, Wwf, Ss, Rb, Rb, Rb, Ss, Sm, Sm, Ur, Ss, Rb, Wo, Rb, Wo, Wo, Ss, Sm, Sm, Wo, Wo, Wo, Wo, Wo, Wo, Wo, Wo, Ww, Wo, Wo, Ww, Ww, Ww, Ww, Ww, Ww, Ww, Sm, Sm, Gll^Fmw, Gll^Fmw, Rb, Sm, Gs^Fds
Sm, Sm, Ss, Rb^Emf, Rb, Rb, Ss, Ss, Ss, Sm, Ww, Ww, Ww, Ww, Ss, Wo, Ss, Rb, Rb, Sm, Sm, Sm, Ss, Wo, Wo, Wo, Ww^Ewl, Wo, Wo, Wo, Wo, Wo, Wo, Ww, Wo, Ww, Ww^Vm, Ww, Ww, Ss, Ss, Sm, Sm, Sm, Sm, Gll^Fmf
Sm, Ss, Ss, Ss, Rb, Ss, Ss, Ss^Vhs, Ss, Ww, Ss, Wo, Ss, Ss, Ss, Ss, Ss, Sm, Rb, Ss, Sm, Sm, Sm, Ss, Ss, Wo, Wo, Wo, Wo, Wo, Wo, Wo, Wo, Ww, Ww, Wo, Wo, Ww, Ww, Ww, Ss, Sm, Ss, Sm, Ss, Gll^Fmw
Ss, Ss, Ss, Chs, Chs, Chs, Chs, Ss, Sm, Wwf, Wwf, Ss, Sm, Sm, Sm, Ss, Ww^Ewl, Sm, Sm, Rb^Emf, Rb, Ww^Ewl, Sm, Ss, Ss^Vhs, Sm, Ss, Wo, Wo, Wo, Wo, Wo, Wo, Ww^Ewl, Wo, Ww, Ww, Ww, Ww, Ww, Ww, Ss, Ww, Ss, Sm, Gll^Fmf
Ss, Ss, Ss, Chs, 3 Khs, Ss, Ss, Ss, Sm, Ww, Rb, Wwf, Ss, Ss, Sm, Sm, Ss, Ss, Sm, Ww, Rb, Ww, Wwr, Ss, Wwf, Sm, Ss, Ss, Wo, Wo, Ss, Wo, Wo, Wo, Wo, Wo, Wo, Sm, Wo, Wo, Wo, Ww, Ww, Wwr, Ww, Gs^Fms
Ss, Ss, Ss, Chs, Ss, Ss, Ss, Sm, Sm, Sm, Rb, Rb, Ss, Ss^Vhs, Sm, Sm, Ss, Ss, Sm, Sm, Ss, Rb, Rb, Wwf, Wwf, Sm, Rb, Wo, Ss, Ss, Ss, Wwf, Wwf, Ss, Ss, Wo, Wo, Wo, Wo, Wo, Wo, Wo, Wo, Ww, Ww, Ww
Sm, Sm, Sm, Sm, Sm, Sm, Sm, Sm, Ur, Ur, Sm, Ss, Ss, Ss, Ss, Ss, Ss, Ss, Ss, Sm, Ss, Ss, Rb, Rb, Rb, Rb, Rb, Ur, Ss, Ss, Ss, Wwf, Ss, Ss, Ss, Ss, Ss, Wo, Wo, Wo, Wo, Wo, Sm, Sm, Ww, Ww
