Hd, Md, Md, Md, Md, Md, Md, Md^Xm, Md, Md, Md, Md, Md^Xm, Md^Xm, Md, Md, Md, Rd, Hd, Hd, Hd, Hd, Hd, Dd, Dd, Dd, Dd, Dd, Dd^Do, Dd, Dd^Edp, Dd, Dd^Edp, Dd, Dd, Dd, Dd, Dd, Dd^Dc, Dd, Re, Dd
Wwrg, Hd, Hd, Hd, Ds, Hd^Dr, Hd, Md, Hd, Md^Xm, Md, Md^Xm, Md, Md, Md, Md, Hd, Hd, Hd^Es, Hd^Es, Dd, Dd, Dd^Edp, Dd^Edp, Rd^Edp, Dd^Edb, Dd^Edb, Dd, Dd^Edp, Dd^Edp, Dd^Edp, Dd^Edpp, Dd^Edpp, Dd, Dd, Rd, Rd, Dd, Re^Edb, Re, Dd, Dd
Wwf, Dd^Edp, Dd, Rd, Wwrg, Ds, Ds^Edp, Ds, Ds, Hd, Hd, Md, Hd, Hd^Dr, Dd^Edpp, Hd^Edb, Hd^Edb, Hd^Es, Dd^Es, Dd, Rd, Dd, Rd, Dd, Rd^Es, Dd, Re, Re, Re, Re^Es, Rd, Re, Rd^Edb, Ds, Re^Es, Dd^Es, Dd^Edb, Re^Edb, Dd^Esd, Rd, Rd, Dd
Wwg, Wwg, Wwg, Wwf, Wog, Wwg, Wog, Wwf, Wog, Ds, Dd, Hd, Ds, Hd, Ds, Hd, Ds, Dd^Es, Rd^Es, Rd, Rd^Edb, Rd^Edb, Rd, Rd, Rd, Rd, Rd, Re^Edb, Rd^Edb, Re^Edb, Hd, Rd^Edb, Dd, Rd^Edb, Re, Rd, Re, Re, Dd, Dd^Edp, Dd^Edpp, Dd^Edp
Dd, Wwf, Wwf, Wwf, Wwf, Wog, Wwf, Wog, Wwf, Wwf, Wwf, Ds, Dd^Edt, Ds^Edt, Dd^Edt, Ds^Edt, Rd, Rd^Edb, Ds^Edb, Ds^Edb, Ds, Ds, Dd, Dd^Es, Dd, Rd, Dd, Dd^Esd, Hd, Hd, Dd^Dr, Mdd, Mdd^Xm, Dd, Dd^Edpp, Re, Re^Edb, Rd, Dd, Dd^Edp, Dd^Edp, Dd^Edp
Dd, Ds, Ds, Dd, Ds, Ds^Edp, Rd, Dd, Dd, Dd^Edpp, Rd, Wwf, Rd, Dd, Rd, Rd, Ds, Ds, Dd, Dd, Hd, Dd, Hd, Dd^Vdt, Dd^Edp, Rd, Rd, Rd^Es, Rd, Dd, Mdd, Mdd, Mdd^Xm, Mdd^Xm, Mdd, Dd, Dd, Re, Rd, Ds^Edpp, Dd^Edp, Dd^Edp
Dd, Rd, Ds^Edp, Ds^Edp, Rd, Dd, Dd, Rd, Rd, Rd, Dd^Edpp, Rd, Dd, Rd, Wwg, Wwg, Wwg, Ds, Rd^Edpp, Dd, Dd, Hd, Hd, Dd^Edp, Dd^Edpp, Dd, Rd, Rd^Es, Rd, Re, Re, Mdd, Mdd, Mdd, Re, Re, Re, Re^Es, Re, Re, Dd, Dd^Edp
Dd, Ds, Dd^Dc, Ds^Edpp, Ds^Edpp, Rd, Rd^Es, Rd, Rd, Dd, Dd^Edp, Rd, Rd, Wwg, Wwg, Wwg, Wwf, Wwg, Wwf, Dd, Ds, Ds^Edb, Ds, Hd, Rd^Edb, Rd^Es, Re, Re, Mdd, Dd, Rd, Re, Re, Dd^Dr, Rd, Rd, Mdd, Dd^Dr, Mdd^Xm, Rd, Rd^Es, Dd
Dd, Dd, Dd, Dd, Ds, Rd, Rd^Es, Rd^Es, Rd^Es, Rd, Rd, Hd, Rd, Rd, Ds, Wwf, Wog, Wog, Wog, Wwrg, Ds^Edp, Ds, Ds^Edt, Rd, Rd, Rd^Edb, Re, Hd, Hd, Mdd, Mdd^Xm, Dd, Rd, Re, Re, Rd, Re, Mdd, Re, Re, Re^Es, Dd
Dd, Dd, Dd^Edb, Dd^Edb, Rd^Edb, Rd^Edb, Hd, Hd, Rd^Es, Dd, Re, Hd, Rd, Rd, Rd, Ds, Ds, Rd^Edp, Wwg, Wog, Wog, Ds^Edp, Dd, Dd, Dd^Dc, Rd^Edb, Re^Edb, Dd, Hd, Mdd, Mdd^Xm, Mdd^Xm, Mdd^Xm, Dd^Esd, Rd, Mdd, Mdd, Re, Dd^Edpp, Re, Rd^Es, Rd
Dd, Rd, Rd, Dd, Rd, Dd, Dd, Rd, Rd^Es, Dd, Re, Dd, Re, Dd, Dd, Dd^Dc, Dd^Edpp, Ds^Edp, Dd, Wwg, Wwg, Wwf, Wwf, Dd, Ds, Rd, Rd^Edb, Dd, Dd, Mdd, Mdd, Mdd^Xm, Mdd, Mdd, Rd, Rd, Rd, Mdd, Re^Es, Re, Dd, Dd
Dd, Dd, Dd^Edp, Rd^Edpp, Rd^Edpp, Dd, Re, Rd, Rd, Dd, Co, Re, Rb, Re, Dd, Dd^Edpp, Rd, Ds, Ds, Dd, Dd^Vdt, Wwg, Wwrg, Ds, Rd, Rd, Rd, Rd, Rd, Hd, Re, Mdd, Re, Re^Es, Re, Re, Re, Re^Es, Mdd, Re, Dd, Dd
Re, Dd, Dd^Edpp, Dd^Edpp, Dd, Dd, Rd^Es, Dd, Rd, Rd, Rd, Co, Co, Rb, Rb, Rd, Dd, Dd, Rd, Dd, Rd, Dd, Rd, Rd, Rd, Re, Re, Re^Es, Re^Es, Re^Es, Re^Es, Rd, Re, Rd, Rd, Mdd, Mdd, Dd^Dr, Mdd, Mdd, Mdd, Dd
Dd, Re^Edp, Re, Dd, Re, Dd, Rd, Rd^Es, Re, Rd, Re, Gd, Rd, Rd, Rd^Es, Rd, Rd, Rd, Hd, Rd, Ds^Edp, Rd, Wwf, Wwf, Wwf, Dd, Ds, Dd, Ds^Edb, Re, Ds^Edp, Re, Dd, Rd, Dd^Dc, Dd, Hd, Mdd, Hd, Mdd, Mdd, Dd
Dd, Dd, Rd, Re, Co, Co, Rd, Rd^Es, Rd^Es, Re, Rb, Gd^Vo, Re, Rd, Rb, Re, Co, Re, Hd, Ds^Edp, Ds^Edp, Rd, Rd, Wog, Wog, Rd^Edp, Ds^Edp, Ds^Edb, Ds^Es, Ds^Edb, Dd, Ds, Dd, Dd, Dd, Hd, Dd^Edpp, Hd, Dd^Esd, Dd, Rd, Rd
Re, Dd, Co, Co, Rb, Rb, Gd, Re, Ur, Rb^Es, Rd^Es, Rd^Es, Rd^Es, Rb^Ecf, Rd, Rd, Co, Re, Re, Dd^Edp, Dd^Dc, Dd, Rd, Ds, Ds, Wwf, Wwf, Ds, Rd, Ds, Rd, Re^Es, Re, Re, Rd, Dd^Edpp, Dd^Edp, Dd, Rd, Rd^Es, Dd, Dd
Dd, Re, Rd, Rd, Gd, Gd^Vo, Gd, Ur, Rd, Ur, Ur, Rd, Rb, Rd, Re^Vct, Rd, Co, Rb, Rd, Hd, Dd^Edb, Rd^Edt, Dd^Edb, Dd, Ds^Edpp, Rd^Edpp, Wog, Wwf, Ds, Rd, Ds, Dd, Hd, Re, Rd, Dd^Edpp, Dd^Do, Dd^Edp, Rd, Dd, Dd, Dd
Dd, Re, Re, Rd^Edt, Rb^Ecf, Rd^Edt, Rd, Rd, Co, Co, Rb, Co, Ur, Ur, Ur^Es, Ur, Rd^Es, Re, Re, Rd, Rd, Rd^Edb, Ds^Edp, Ds^Edp, Dd, Wwf, Wwf, Wog, Ds, Gd^Edt, Dd^Do, Hd, Ds, Hd, Rd, Ds^Edp, Ds^Edp, Ds^Edb, Rd, Ds^Edb, Dd, Dd
Re, Re, Co, Rd^Edb, Re^Edb, Rd, Gd, Co, Rb, Rb, Re, Co, Rb, Rb, Rd, Rd^Es, Rd, Re^Es, Re, Dd, Hd, Hd, Rd, Rd, Ds, Ds^Edp, Ds, Wwf, Ds, Gd^Edb, Dd^Edpp, Dd^Edp, Re, Re^Edb, Rd, Rd, Re^Es, Re^Es, Re, Dd, Dd, Dd
Re, Re, Co, Rd^Edb, Re, Gd^Fetd, Gd^Vo, Rb, Co, Re, Re, Co, Re, Re, Rd, Rb^Ecf, Rd, Hd, Rd, Dd^Edp, Dd, Dd^Vdt, Dd, Rd, Rd^Edb, Rd, Rd^Edb, Dd^Edp, Rd, Gd, Gd, Re, Rd, Rd^Edb, Re^Edb, Re, Dd^Vdt, Dd, Dd, Rd, Rd^Es, Dd
Rd, Rb, Co, Rd, Rd, Gd, Rb, Rb, Ur, Co, Co, Re, Gd, Gd^Vo, Rd, Rd, Co, Hd, Re^Es, Rd^Es, Rd^Es, Dd, Dd, Rd, Re, Dd^Edb, Dd^Edb, Rd^Edb, Rd^Edb, Rd, Rd, Gll, Dd, Dd, Dd^Edp, Rd, Dd^Edp, Dd, Dd, Dd^Es, Dd^Edt, Dd
Rd, Rd, Re, Rd, Co, Rd, Rd, Ur, Rb^Es, Rb, Re, Rb, Gd, Gd, Co, Co, Dd, Hd, Dd, Rd, Hd, Rd^Es, Re^Edt, Re, Rd^Edt, Dd, Dd, Ds, Wwf, Wwrg, Rd^Edp, Gll^Feth, Gll, Dd, Dd, Dd^Edp, Dd^Dc, Dd^Edp, Dd^Edpp, Dd, Dd^Edt, Dd
Re, Re, Dd^Edp, Dd, Rb, Co, Co, Ur^Edb, Rd^Edb, Rb, Re^Vct, Rd, Co, Co, Rb, Rb, Rd, Re, Dd, Rd, Rd, Dd^Esd, Rd, Rd^Edt, Dd^Edt, Rd^Edb, Rd, Ds, Wwf, Wwg, Wwf, Rd, Rd, Gd, Dd, Dd^Edp, Dd^Edp, Dd^Edp, Dd^Edp, Dd, Rd, Rd
Rd, Dd^Edp, Rd^Edp, Dd^Edp, Dd^Edp, Rb, Rb, Co, Rd^Es, Rd^Edb, Rd^Edb, Rd, Dd, Re, Dd^Edb, Dd^Edb, Rd, Dd, Dd^Edpp, Rd, Dd, Hd, Hd, Hd, Hd, Dd^Es, Dd^Es, Rd, Wwf, Wog, Wog, Wwrg, Ds, Dd^Es, Dd^Dc, Dd^Edp, Dd^Edpp, Dd, Dd^Edb, Dd^Edpp, Dd, Dd
Rd, Rd, Dd, Re^Edp, Rd, Re^Edp, Dd, Dd, Rd, Re^Es, Dd, Dd, Dd^Edpp, Rd^Edpp, Rd^Edp, Dd^Edp, Dd^Edp, Rd, Dd, Dd^Dc, Dd, Dd, Rd, Rd, Rd, Hd, Hd, Ds, Ds, Wog, Wwf, Wwf, Ds, Dd^Es, Dd, Dd, Dd, Rd, Rd^Edb, Dd^Edb, Rd^Edb, Dd
Dd, Dd^Vdt, Dd, Re, Dd, Rd, Dd, Dd, Dd, Rd, Rd, Dd, Dd, Rd, Rd, Dd, Dd, Dd, Dd, Dd, Dd, Dd, Dd, Dd, Dd, Rd, Rd, Dd, Dd, Dd, Wwf, Wwf, Dd, Dd, Dd, Dd, Dd, Dd, Dd, Rd^Edt, Rd, Dd
