Md^Xm, Md^Xm, Md^Xm, Md^Xm, Md^Xm, Re, Re, Mm^Xm, Mm^Xm, Hh, Hh, Hh, Hh, Hh, Gs^Fms, Gg, Gg, Ww, Wog, Wog, Wog, Wog, Wog, Ww, Ds, Gg, Gs^Fms, Rp, Rp, Hh, Hh, Hh, Hh^Fms, Hh, Hhd, Hhd, Hhd, Ds, Ds, Ds, Ds, Gg, Dd, Dd^Edp, Dd, Dd, Hd, Dd, Dd, Dd
Md^Xm, Md^Xm, Mv^Dr, Md^Xm, Md, Re, Re, Hhd^Es, Mm^Xm, Mm^Xm, Mm, Hh, Hh^Es, Hh, Gs^Fms, Gg^Es, Gg, Ds^Esd, Ww^Ewl, Wog, Wog, Wog, Wwt, Ww, Gs^Fds, Gs^Fds, Rp, Rp, Gg, Gg, Gg^Efm, Hh^Fms, Hh^Fms, Hh, Gs, Hhd, Hhd, Hhd, Ds, Ds^Esd, Dd^Ftd, Hd, Hd, Dd, Hd, Dd^Edp, Dd, Hd, Dd^Edp, Dd
Md^Xm, Mm, Mm, Mm, Gll^Fmw, Hhd^Es, Re, Mm^Xm, Mm, Mm, Hhd, Hhd, Hh, Hh^Fms, Gs^Fms, Gs^Fms, Gg, Ds, Gg, Ww, Wwrt, Wwt, Wwrt, Wwr, Rd, Gs^Fms, Gg^Es, Rp, Rp, Gg^Es, Gs^Fms, Gs, Gg, Gs, Gs, Gd, Rd, Ds, Ds, Dd^Vdr, Dd, Dd, Dd, Dd^Edpp, 1 Hd, Hd, Dd, Dd^Vdr, Dd^Esd, Dd
Md^Xm, Md^Xm, Hhd, Gll^Fmw, Cfr, Hhd^Vhhr, Hh^Fms, Re, Gll^Fmw, Gll^Fmw, Hh, Hh, Mm, Gs^Fms, Mm, Gs^Fms, Gs^Fms, Gg, Gg, Wwt, Wwt, Wwt, Wwrt, Wwt, Wwrt, Gs^Fds, Rd, Gs^Fds, Gg^Efm, Rp, Gs^Fds, Gs^Fds, Gs^Fms, Gs^Vh, Gg^Es, Gg, Ds, Gd^Em, Rd, Dd, Cdr, Cdr^Esd, Dd^Ftd, Dd, Dd^Dc, Dd, Dd^Ftd, Hd, Hd^Edpp, Dd
Hh, Md, Mm, Mm^Xm, Cfr, Kfr, Cfr, Re, Mm, Gll^Fmw, Mm, Mm, Gs^Vh, Hh^Gvs, Mm, Mm, Gg^Es, Gg, Gg^Es, Gg, Wwr, Wwt, Ww, Ww, Ww, Ww^Ewl, Gs^Fms, Rd, Gs, Gg^Efm, Gs^Fds, Gs^Fms, Gs^Fds, Gs^Fds, Rd, Gg^Efm, Gs, Ds, Gd^Esd, Ds, Cdr^Esd, Wwt, Kdr, Cdr^Esd, Cdr^Esd, Dd, Dd^Esd, Dd, Dd, Dd
Hhd, Mm, Mm, Cfr, Gll^Fmw, Cfr, Hh, Hh, Mm^Xm, Hh, Hh, Mm, Mm, Mm, Gs^Fms, Gg, Hh, Hh, Hh, Ds^Esd, Ww, Ww, Wog, Wog, Wo, Ww, Ds, Rd, Rd, Gs^Fms, Gs^Em, Gs^Fms, Gs^Fds, Gs^Fms, Gg^Efm, Rd, Gs^Fds, Ds, Rd, Rd, Rd, Cdr, Dd^Ftd, Wwt, Cdr, Ds, Dd^Vdr, Hd, Hd, Ds
Hh, Hhd^Es, Gll^Fmw, Hhd^Es, Hh, Hh, Hh, Mm, Mm, Mm, Gs^Fms, Hh, Gs^Fms, Gs^Fms, Gg^Es, Rp, Gs^Fms, Hh^Fms, Hh, Ds, Ww, Wog, Wog, Wog, Wog, Ww, Ww, Gg^Es, Gg^Efm, Rd, Gs, Rd, Rd, Rd, Gg^Es, Rd, Gs^Fms, Rd, Ds, Gd^Em, Gs, Rd, Hhd, Cdr^Esd, Hhd, Ds, Ds, Dd, Ds, Ds
Hhd, Hh, Hh, Hh, Hh, Mm, Gs^Fms, Gs^Fms, Gg^Es, Gg, Gg, Gs^Fms, Hh, Mm, Hh, Rr, Rp, Rp, Gs^Fms, Ww, Ww, Wog, Wo, Wo, Wo, Ww, Ww, Ds, Gg, Gs, Gs, Gs^Vh, Gs^Fms, Hh, Gs, Rd, Rd, Gs^Fds, Gs^Fds, Ds, Hh, Gd, Gs, Hhd, Hhd, Hhd, Ds^Esd, Ds^Esd, Ds, Ds
Gg, Hh^Fms, Gs^Fms, Gll^Fmw, Gg, Hh^Fms, Gs^Fms, Gs^Fms, Gll^Fmw, Gs^Fms, Gll^Fmw, Gg, Gg, Hh, Gg, Gs^Fms, Rr, Gs^Fms, Gs^Fms, Ds, Ww^Ewl, Wog, Wog, Wo, Wog, Ww, Ww, Ds^Esd, Gg, Gg^Es, Gs^Fds, Gs^Fds, Hh^Fms, Hh, Hh, Gg^Efm, Gs, Rd, Gs^Vh, Hh, Hh, Hh, Gs, Gd, Gd^Em, Rd^Esd, Ds, Gd, Rd, Ds
Gg, Gs^Fms, Gll^Fmw, Gg^Es, Ss, Gll^Fmw, Gll^Fmw, Gs^Fms, Gs^Fms, Gs^Fms, Gs, Gg, Gg^Es, Gs, Gs, Gg^Es, Rr, Gg, Gg, Wwf, Wwf, Wo, Wo, Wo, Wog, Wo, Ww, Ds, Gg, Gg^Efm, Gg^Efm, Gs^Fms, Gs^Fds, Hh^Fms, Gs^Fds, Gs, Gs^Es, Gs^Fms, Gs^Fds, Gs^Fds, Hh^Fms, Hh, Gs^Fms, Gs, Gd, Ds, Gd, Ds, Ds, Hhd
Ss, Gs^Fms, Wwf, Ss, Sm, Ss, Wwf, Gg, Khs, Gg, Hh^Fms, Hh, Gs, Gg, Wwf, Gs, Wwf^Bw|r, Gg^Es, Wwf, Wwf, Ds^Esd, Ww, Ww, Wo, Wo, Wo, Ww, Ww, Ds, Gg^Efm, Gs^Fms, Gs^Fds, Gs^Fms, Gs^Fds, Gs^Fms, Gg, Gg^Efm, Gs^Fms, Gs^Fds, Gs^Fms, Gs^Fds, Gs^Fds, Gs^Fms, Gs^Fds, Gs^Fds, Gs^Fms, Gs, Gd, Gg, Gg
Ss, Ss, Ss^Vhs, Wwf, Ss, Wwf, Ss, Wwf, Sm, Chs, Hh^Fms, Hh, Wwf, Wwf, Rp, Wwf, Rr, Wwf, Gs, Gg^Es, Gg, Ds, Ww, Wo, Wo, Wo, Sm, Ww, Ww, Gs^Fds, Gs, Gs^Es, Gs, Gs^Fds, Gg^Efm, Rd, Gg, Gs, Gg^Efm, Hh, Gs^Fms, Gs^Fms, Gs^Em, Gs^Fds, Gg^Efm, Gs, Gs^Fds, Gg, Hh^Fms, Hh
Ss, Sm, Sm, Sm, Wwf, Ss, Wwf, Ss, Chs, Chs, Gg, Wwf, Rr, Rr, Rp, Rp, Gg^Es, Rr, Rr, Hh^Es, Hh, Ds^Esd, Ww, Wo, Wo, Wo, Sm, Sm, Sm, Ds^Esd, Ds, Gs, Gs^Fms, Gg^Efm, Gg^Efm, Rd, Rd, Rd, Gg^Efm, Gg^Es, Hh^Fms, Gs^Em, Gs^Fms, Gg^Efm, Gs^Fds, Gs^Fms, Gg^Efm, Gg^Es, Hh, Hh^Fms
Hh, Gg, Gg^Es, Ss, Ss, Wwf, Sm, Wwf, Chs, Gg, Rr, Wwf, Gs, Gg, Re^Gvs, Re^Gvs, Re^Gvs, Gs, Rr, Hh, Hh, Ds, Ww, Wo, Wo, Wo, Wo, Sm, Ww, Sm, Ww^Em, Gs^Fds, Rd, Rd, Rd, Rd, Gs^Vh, Gg, Gg, Hh, Hh, Gs^Fms, Gs^Fds, Gs^Fms, Gg^Efm, Gg^Efm, Gg, Gg, Gg^Eff, Hh
Hh, Hh, Gg, Gs, Gg^Es, Gg, Rp, Rp, Rp, Chs, Wwf, Wwf, Gs, Re^Gvs, Gg^Em, Re^Gvs, Gs^Vh, Gg^Em, Re^Gvs, Rp, Rp, Gs, Sm, Sm, Wo, Wo, Wo, Wo, Ww^Ewf, Ww, Wo^Bp/, Ww^Bp/, Ww^Ewl, Gg, Gg^Es, Gg, Gg, Rd, Rd, Gs, Rd, Gg, Gg, Gg^Es, Gs^Vh, Gg, Gg^Wm, Gg^Eff, Re^Gvs, Re^Gvs
Gg, Gg^Es, Re^Gvs, Re^Gvs, Re^Gvs, Gg^Wm, Gg, Rr, Gg^Es, Gs, Gg, Gs, Hh, Gg^Em, Gg^Em, Gg^Emf, Re^Gvs, Re^Gvs, Re^Gvs, Gg^Wm, Rp, Rp, Ww^Ewl, Ww, Wo, Wo, Sm, Sm, Ss^Bp/, Wo^Bp/, Wo, Wo, Ww, Ds, Wwr, Ds, Ds^Esd, Gg, Gg^Es, Rd, Gs, Rd, Gg, Gs^Vh, Rp, Rp, Gg^Eff, Gg^Eff, Re^Gvs, Re^Gvs
Gg, Re^Gvs, Re^Gvs, Re^Gvs, Re^Gvs, Re^Gvs, Gs^Vh, Rr, Rp, Gg^Es, Gs^Fms, Gg, Rp, Rp, Co, Gg^Ebn, Co, Re^Gvs, Gs, Re^Gvs, Gg, Rp, Ds, Ww, Wo, Ww^Ewl, Ss^Vhs, Chs, Khs, Chs, Ss^Em, Wo, Wo, Ww, Ww, Ww^Ewl, Ww, Gg, Gs, Gs, Rp, Gg, Rp, Rp, Gg^Eff, Gg^Eff, Re^Gvs, Re^Gvs, Re^Es, Re^Gvs
Hh, Gs^Fms, Gg, Re^Gvs, Re^Gvs, Re^Gvs, Gg, Rp, Rp, Gs^Fms, Hh^Fms, Hh^Fms, Rp, Rp^Edt, Rp^Em, Co, Rp, Rp, Gg^Es, Gs, Hh, Gs, Wwr, Ww, Wo, Ss^Em, Ss^Bp/, Chs, Ss^Bp\, Sm, Ss^Em, Wo, Wo, Wo, Ww, Sm, Ww, Ds, Ds, Gs, Rp, Rp, Rp, Gg^Eff, Gg^Eff, Re^Gvs, Re^Gvs, Re^Gvs, Re^Gvs, Re^Gvs
Hh, Gs^Fms, Re^Vct, Gg, Gs, Gg, Hh, Gg^Es, Gg, Rr, Hh, Hh, Rp, Rp^Es, Rp^Edt, Ko, Co, Co, Hh, Hh, Hh, Gg^Es, Sm, Ww, Wot^Bp/, Wo^Bp/, Wo, Sm, Wo, Wo^Bp\, Wo^Bp\, Wo, Ww, Ww, Wwr, Wwf, Ww, Ww, Ww, Ds, Rp, Gg^Es, Gg, Rp, Ds, Ds, Ds, Re^Gvs, Wo, Re^Gvs
Hh, Hh, Gg^Es, Gg^Ecf, Gs, Hh, Hh^Es, Hh, Hh, Rr, Rr, Rp, Rr, Rp, Rp, Rp^Edt, Co, Rp^Ebn, Hh, Hh^Fms, Gs^Fms, Gs, Rb, Ww^Bp/, Sm, Ww, Sm, Wo, Ww, Ww^Ewf, Ww^Bp|, Wwr, Ww, Ww, Ww, Wwf, Wo, Ww, Wo, Wo^Bsb/, Wwr, Wwr, Wo^Bw/, Rp, Wo, Ww, Ww, Wo, Ww, Wo
Hh^Fms, Hh, Gs^Fms, Re^Vct, Gg, Hh, Hh^Fms, Hh^Fms, Gs^Fms, Gg, Rp, Rp, Gg, Gs, Gs^Wm, Rp, Gs, Gg, Gs, Gs^Fms, Hh, Rr, Gs, Gg, Gs^Fms, Wwr, Hh^Fms, Sm, Gs^Fms, Ww^Em, Rb, Gs^Fms, Gs^Fms, Ds, Chr, Chw, Rr, Wo^Bsb/, Wwr, Wwr, Ww^Bw/, Ww^Bw/r, Wwr, Ww, Ww^Ewf, Ww, Ww, Wwr, Ww, Ww
Hh^Fms, Hh, Hh, Gg, Gg, Gs^Es, Gg, Gs^Fms, Gg, Gg^Es, Rp, Rr, Gs, Re^Gvs, Re^Gvs, Re^Gvs, Re^Gvs, Gg^Es, Gg, Gg, Rr, Rr, Gg, Gg^Es, Re^Gvs, Gs^Fms, Gg^Es, Hh, Gs, Rb, Gs^Fms, Hh^Fms, Re^Vct, Gs, Gs, Chr, Rr, Gd^Ebn, Rr, Rr, Khr, Ds, Ds, Ww, Gll^Fdw, Ww, Ww, Ww, Ds, Ww
Hh, Hh, Cer, Gs^Fms, Cer^Edb, Cer, Cer^Edb, Gg, Cer^Edb, Gg^Es, Rr, Rp, Gs, Re^Gvs, Re^Gvs, Re^Gvs, Re^Gvs, Re^Gvs, Gs^Vh, Rp, Rr, Gs, Re^Gvs, Re^Gvs, Re^Es, Re^Gvs, Re^Gvs, Gs^Vh, Gg, Rb, Gg, Hh^Fms, Gs^Fms, Gs, Rp, Rp, Rp, Rp, Rp, Rr, Gg^Ve, Gll^Fmw, Gd, Gll^Fdw, Gll^Fmw, Gll^Fmw, Ds, Ds^Esd, Ds^Esd, Ds^Esd
Gg, Cer^Edb, Ias, Cer^Edb, Gg, Gg, Gll^Fdw, Gg, Gg, Cer^Edb, Cer^Edb, Gg, Gg, Gs^Edb, Gg^Fms, Re^Gvs, Re^Gvs, Re^Gvs, Gg^Fms, Rr, Rp, Gg^Es, Gg, Re^Gvs, Re^Gvs, Re^Gvs, Re^Gvs, Re^Gvs, Gs, Gs, Hh, Gg^Es, Gg, Rp, Rr, Rp, Gg^Es, Re, Gll^Fmw, Gll^Fmw, Gll^Fdw, Gll^Fmw, Gd^Em, Gll^Fdw, Gll^Fmw, Gd^Fetd, Gll^Fdw, Ds, Gll^Fmw, Ds^Esd
Gs, Gg, Gd^Vo, Gs, Gs, Gll^Fdw, Gs, Gg^Es, Gg^Es, Ker^Edb, Gg, Cer, Gg, Cer, Cer^Edb, Hh, Hh^Fms, Hh^Fms, Rp, Gs, Rr, Hh, Hh, Gs, Gs, Re^Gvs, Co, Gg^Wm, Gg, Gs^Fds, Hh^Fms, Hh, Gs, Rp, Gs, Gg, Gll^Fmw, Re, Re^Em, Gll^Fdw, Gll^Fmw, Gll^Fmw, Gll^Fmw, Gd, Gd^Es, Gll^Fdw, Gll^Fdw, Gll^Fmw, Gll^Fmw, Gg
Gg, Gs^Es, Rp, Gs^Em, Gs^Ecf, Gs^Es, Gs, Gs^Vc, Gs, Gg, Gs^Es, Gg, Gs, Gg, Gg, Cer, Rp, Rp, Gs, Rp, Gs^Es, Rr, Rr, Rr, Rr, Gg, Co, Gg^Es, Co, Gs^Fms, Gs^Fms, Gs^Fms, Re^Gvs, Gg^Es, Gs, Gll^Fdw, Gll^Fmw, Gll^Fdw, Gll^Fdw, Re, Gll^Fdw, Gll^Fmw, Gll^Fmw, Cvr, Gll^Fmw, Gll^Em, Gll^Fmw, Gll^Fdw, Gd, Gg
Ias, Gs, Rp, Gs, Gll^Fdw, Gll^Feth, Gd, Gs^Es, Gll^Fdw, Gs, Rp^Es, Gd^Vo, Gs^Es, Gs, Gg, Cer^Edb, Gg, Gg, Cer^Edb, Gs, Cer, Gg, Gs, Gs, Gs, Gg, Ko, Gg, Gg, Gg, Re^Gvs, Re^Gvs, Re^Gvs, Re^Gvs, Gg, Gll^Fdw, Gll^Fdw, Gd^Fetd, Gll^Fmw, Gll^Fdw, Gll^Fmw, Re, Re, Cvr, Gll^Fdw, Gg^Ve, Gll^Fdw, Gd, Re, Gg
Gd, Rp, Rp, Gd^Em, Rp, Gd^Vo, Rp, Gd^Fetd, Rp, Rp, Gd^Em, Rp, Gd, Gd, Gd^Es, Rd, Rd, Cer, Gg^Em, Cer^Edb, Gg, Cer^Edb, Cer, Gg, Gg, Co, Gs, Co, Co, Gg^Es, Gg, Re^Gvs, Gs, Re^Gvs, Gs, Gg, Gd, Gg^Em, Gll^Fdw, Gll^Fmw, Gll^Fmw, Gll^Fmw, Cvr, Kvr, Cvr, Gll^Fmw, Re, Re^Em, Gll^Fmw, Re
Rp, Gs^Em, Rp, Rp, Rp, Rp, Co^Xo, Rp, Rp, Gd^Es, Gd, Gs^Ecf, Rd, Rd, Gll^Feth, Gd, Gd^Es, Gd, Gs, Gs, Gd, Gg, Gg, Gg^Es, Gg, Gg, Gs, Gs^Es, Gs, Gg, Gs^Es, Gg, Rr, Gs, Hh, Gg^Es, Gg, Gd, Gll^Fdw, Gll^Fdw, Re, Gg^Ve, Re, Gll^Feth, Gd, Re, Gll^Fdw, Gll^Fdw, Gd^Em, Gg
Co^Xo, Rp, Ko^Xo, Co^Xo, Co^Xo, Ko^Xo, Cf, Co^Xo, Co^Xo, Rp, Gd^Es, Rd, Rd, Gll^Fdw, Gs^Vc, Gll^Fdw, Rp, Rp, Gd^Vo, Gll^Fdw, Gd^Fetd, Gd^Es, Gg, Cer, Cer^Edb, Gs, Gg^Es, Gg, Rr, Rr, Gs, Gg, Gs, Rr, Gg, Gs, Rp, Gg, Re^Em, Re, Gll^Fmw, Re, Gg, Cvr, Gd, Gd^Em, Gll^Fdw, Gll^Fmw, Gll^Fmw, Gg
Cf, Co^Xo, Cf^Es, Cf, Cf^Es, 4 Cf, Kf, Cf, Cf, 5 Rr^Pr\o, Rr^Pr\o, Rd, Rp, Gs, Gs^Es, Rp, Rp, Gs, Rp, Rp, Gll^Fdw, Gll^Fdw, Gs, Ker^Edb, Cer, Gs, Gg, Rr, Gs^Fms, Gs^Fms, Gs, Co, Gg, Co, Gs, Rr, Rp, Rp, Gll^Fdw, Gs^Fms, Gll^Fdw, Gll^Fmw, Gll^Fmw, Gs^Fms, Gg, Gll^Fdw, Gd^Fetd, Gll^Fmw, Gll^Fmw, Gll^Fmf
Cf^Es, Cf, Cf^Es, Cf, 3 Kf, Cf^Ebn, Cf, Cf^Es, Cf^Es, Cf, Cf, Co^Xo, Ko^Xo, Rp, Rp, Rp, Rp, Gs^Es, Gs^Ecf, Rp, Rp, Gs^Vc, Gg^Es, Gg, Gg, Gs, Cer^Edb, Gs^Fms, Hh^Fms, Hh^Fms, Gs^Fms, Co, Ko, Co, Gs^Fms, Hh, Gs^Fms, Rp, Gg, Gll^Fmw, Gll^Fmw, Gs^Fms, Gll^Fdw, Gll^Fmw, Gs^Fms, Gg, Gll^Fdw, Gll^Fdw, Gg, Gg
Cf^Es, Cf, Kf, Cf^Ebn, Cf, Cf^Es, Cf^Es, Cf, 8 Cf, Cf^Es, Kf, Cf, Co^Xo, Rp, Gs^Es, Gd^Fetd, Rp, Gs^Es, Gd, Rp, Gd^Es, Gd, Gs, Gs, Gg, Gs, Cer, Gs, Hh, Gs^Fms, Rr, Gg^Es, Co, Gs^Fms, Hh, Hh^Fms, Rp, Rr, Rp, Gs^Fms, Gg^Ve, Gs^Fms, Gg^Ve, Gll^Fmw, Gs^Fms, Gll^Fmw, Gll^Fdw, Gll^Fdw, Gll^Fmw, Gg
Cf, Cf^Es, Cf, Cf, Cf^Es, 2 Cf, Cf, Cf^Es, Kf, Cf^Ebn, Cf, 6 Cf, Cf, Co^Xo, Rp, Gs^Em, Rp, Rp, Rp, Gd^Vo, Gs, Gs, Gll^Fdw, Gll^Fdw, Gg^Es, Gg, Cer^Edb, Gg, Gg, Gs, Rp, Gg, Rp, Gg, Rp, Gg^Es, Rp, Rp, Gs^Fds, Gll^Fmw, Gs^Fds, Gll^Fmw, Gll^Fmw, Gs^Fms, Gll^Fdw, Gll^Fmw, Gs^Fms, Gs^Fms, Gll^Fmw, Gs^Fds
Cf, Cf, Kud, Cf, Cf, Cf^Es, Kf, Cf^Ebn, 7 Cf, Cf, Cf^Es, Cf^Es, Cf, Ko^Xo, Co^Xo, Rp, Gd^Es, Rp, Rp, Gd^Es, Gd, Gs, Gg^Em, Gll^Feth, Gg, Gg, Cer, Cer^Edb, Gs, Gg^Es, Rp, Rp, Rp, Rr, Gg^Es, Rr, Gs^Fms, Gs^Fms, Gs^Fds, Gs^Fms, Gs^Fds, Gs^Fms, Gs^Fds, Gs^Fds, Gll^Fmw, Gs^Fds, Gs^Fds, Gs^Fds, Gs^Fms, Gg^Fet
Ias, Cf, Cf, Cf^Es, Cf, Cf, Cf, Cf, Cf, Cf^Es, Cf, Cf^Es, Cf, Cf, Co^Xo, Rp, Gd, Gd, Gd, Ias, Gg, Gg, Gg, Gg, Gg, Gg, Gg, Gg, Gg, Gs, Gg, Rr, Gg, Gs, Gg, Gs^Fds, Gg, Gg^Fet, Gs^Fds, Gs^Fds, Gs^Fds, Gs^Fms, Gg^Fet, Gs^Fds, Gs^Fds, Gs^Fds, Gs^Fds, Gs^Fms, Gs^Fds, Gs^Fds
