Gg, Gg, Gg, Gg, Gd, Gg, Gg, Gg, Gg, Gg, Gg, Gg, Gs, Gs, Gs, Gs, Gg, Gg, Gg, Gg, Rr, Rr, Gs, Gs, Gg, Gs, Gg, Gg, Gg, Gg, Rr, Rr
Gll, Gs, Gd, Gd, Gg, Gd, Gg, Gg, Gs, Gs, Gs, Gs, Gg, Gg, Gll, Gg, Gg, Gg, Gg, Gg, Rr, Rr, Gs, Gg, Re^Vct, Gs, Gg, Gg, Gg, Rr, Rr, Gg
Gg, Gs, Gs, Gg, Gg, Gg^Ecf, Gg, Gg, Gd, Gd, Re^Vct, Gg, Gll, Gd, Gg, Gs, Gg, Gg, Gd, Gd, Gs, Rr, Gg, Gs, Gs, Gs, Gg, Gg, Gg, Rr, Rr, Gg
Gg, Gd, Gd, Gs, Gs, Gs, Gll, Gll, Gg, Gg, Gg, Gll, Gg, Gd, Gg, Gg^Ecf, Gs, Gs, Gg, Gs, Rr, Rr, Gg, Gg, Gg, Gg, Gg, Gg, Gg, Gg, Rr, Gg
Gg, Gg, Co, Gg, Co, Gg, Co, Gg, Gg, Gg, Gg, Gg, Ko, Gg, Gg, Gg, Gg, Gg, Ko, Rr, Rr, Rr, Gg, Gg, Gg, Gg, Gg, Gg, Gg, Gg, Gg, Rr
Co, Co, Co, Co, Co, Co, Ce, Co, Ce, Ce, Ce, Ce, Re, Co, Ko, Gg, Ce, Co, Re, Re, Re, Rr, Rr, Gg, Gg, Gg, Gg, Gg, Gg^Ecf, Gg, Rr, Rr
Re, Co, Re, Re, Re, Co, Re, Re, Re, Re, Re, Re, Gd, Re, Re, Ce, Re, Re, Rb, Rb, Gd^Vo, Re, Re, Ko, Ce, Gg, Rr, Gg, Rr, Rr, Rr, Rr
Rb, Rb, Ko, Co, Co, Rb, Rb, Rb, Rb^Es, Rb, Rb, Rb, Rb, Gd^Vo, Gd, Re, Re, Rb, Gd, Gd, Gd^Es, Gd, Rb, Re, Rr, Rr, Rr, Rr, Rr, Rr, Gg, Gs
Re, Re, Co, Re, Re, Re, Re, Re, Re, Re, Re, Rb, Gd, Gd, Re^Ebn, Rb, Gd^Es, Gd^Vo, Re, Re, Rb, Re, Gd, Re, Re^Es, Rr, Co, Rr, Gg, Rr, Rr, Gs
Rr, Gd, Gd, Gd, Gd, Gd, Co, Co, Re, Re, Gd^Edt, Gd, Gd^Vo, Gd, Re, Rb, Re, Re, Rb, Rb, Re, Rb, Rb, Gd^Vo, Rb, Re, Re, Ko, Gg, Gg, Gg, Rr
Gd, Rr, Rr, Co, Co, Co, Gd, Re, Gd, Gd, Gd, Gd, Gd, Gd, Rb, Rb, Gd^Vo, Gd, Rb, Re, Gd^Vo, Gd, Gd, Rb, Gd, Re, Re, Ce, Gg, Gg, Gg, Rr
Re, Re, Re, Rr, Re^Es, Re, Gd, Re, Gd, Gd, Gd, Gd, Gd, Re, Re, Gd, Re, Gd, Rb, Re, Gd, Gd, Rb, Rb^Ebn, Re, Gd^Vo, Re, Ko, Gg, Gg, Gs, Gs
Gd, Gd, Co, Gd, Gd, Gd^Edt, Gd, Re, Gd, Gd, Gd, Gd, Gd, Gd, Gd, Re, Re, Re^Edt, Rb, Re, Rb, Rb, Re, Re, Rb, Re, Re, Co, Gg, Gg, Gs, Re^Vct
Rb, Rb, Co, Rb, Rb, Re, Re, Rr, Gd, Gd^Es, Rr, Gd, Gd, Gd, Rr, Re, Re, Re, Rb, Rb, Gd, Rr, Gd^Vo, Gd, Rb, Re, Re, Ko, Gg, Gg, Gg, Gs
Rb, Rb, Co, Ko, Rb, Rb, Rb, Re, Re, Rr, Rr, Rr, Gd, Rr, Re, Rr, Rr, Re, Gd, Rb, Gd, Gd, Gd, Re, Re, Rb, Re, Co, Co, Gg, Gg, Gg
Rb, Rb, Co, Rb, Rb, Re, Re, Re, Re, Re, Re, Rr, Re, Re, Gd, Rb, Gd, Re^Es, Gd, Rb, Gd, Gd^Es, Gd, Re, Re, Rb, Co, Co, Co, Gg, Gg, Gg
Rr, Rr, Re, Rb, Rb, Re, Re, Rr^Edt, Rr, Re, Rb, Re, Co, Gd, Co, Rb, Gd, Re, Gd, Rb, Gd, Gd, Gd, Re, Re, Co, Co, Co, Co, Gg, Gg, Gg
Rb, Rr, Rb, Re, Rb^Es, Rb, Rr, Rr^Es, Re, Rb, Rb, Rb, Rb, Co, Gd, Co, Co, Re, Co, Co, Gd, Gd, Gd, Re, Re, Co, Co, Co, Co, Gg, Gg, Gg
Rb, Rb, Co, Rb, Re, Rb, Re, Re, Re, Re^Edt, Re, Re, Re, Re, Gd, Co, Gd, Ko, Co, Co, Co, Gd, Gd, Re, Re^Es, Rb, Re, Co, Co, Gg, Gg, Gg
Rb, Rb, Co, Rb, Rb, Re, Re, Re, Re^Es, Rb, Rb, Rb, Co, Co, Co, Co, Gd, Re, Gd, Co, Gd, Gd, Gd, Re, Re, Rb, Re, Co, Co, Gg, Gg, Gg
Rb, Rb, Co, Co, Rb, Re, Re, Re, Re, Re, Re, Rb, Rb, 1 Co, Gd, Co, Co, Re, Gd, Rb, Gd, Gd, Gd, Re, Re, Rb, Re, Co, Co, Gg, Gg, Gg
Rb, Rb, Rb, Rb, Rb, Rb, Re, Re, Rb, Re, Rb, Rb, Rb, Rb, Gd, Rb, Gd, Re, Gd, Rb, Gd, Gd, Gd, Re, Re, Rb, Re, Co, Co, Gg, Gg, Gg
