Co, Co, Co, Gg, Gs, Gs, Rp, Gs^Em, Rp, Rp, Rp, Rp, Co, Rp, Rp, Gd^Es, Gd, Gs^Ecf, Rd, Rd, Gll^Feth, Gd
Cf, Co, Cf, Ko, Co, Gg, Co, Rp, Ko, Co, Co, Ko, Cf, Co, Co, Rp, Gd^Es, Rd, Rd, Gll^Fdw, Gs^Vc, Gll^Fdw
Cf, Cf, Cf, Cf, Cf, Co, Cf, Co, Cf^Es, Cf, Cf^Es, Cf, Kf, Cf, Cf, Rr^Pr\o, Rr^Pr\o, Rd, Rp, Gs, Gs^Es, Rp
Cf, Cf, Cf, Cf^Efs, Cf, Cf, Cf^Es, Cf, Cf^Es, Cf, Kf, Cf^Ebn, Cf, Cf^Es, Cf^Es, Cf, Cf, Co, Ko, Rp, Rp, Rp
Cf, Cf, Cf^Efs, Cf, Cf, Kfr, Cf^Es, Cf, Kf, Cf^Ebn, Cf, Cf^Es, Cf^Es, Cf, Cf, Cf, Kf, Cf, Co, Rp, Gs^Es, Gd^Fetd
Cf, Cf, Cf, Cf, Cf, Cf, Cf, Cf^Es, Cf, Cf, Cf^Es, Cf, Cf, Cf^Es, Kf, Cf^Ebn, Cf, Cf, Cf, Co, Rp, Gs^Em
Co, Cf, Cf, Cf, Cf^Efs, Cf, Cf, Cf, Kud, Cf, Cf, Cf^Es, Kf, Cf^Ebn, Cf, Cf, Cf^Es, Cf^Es, Cf, Ko, Co, Rp
Rd, Ko, Co, Cf, Cf, Cf, Cf, Cf, Cf, Cf^Es, Cf, Cf, Cf, Cf, Cf, Cf^Es, Cf, Cf^Es, Cf, Cf, Co, Rp
Re, Rb, Co, Cf, Cf, Cf, Cf, Cf, Cf, Cf, Cf, Cf, Cf, Cf, Cf, Cf, Cf, Cf, Cf, Cf, Ko, Gs
Re, Rd, Rp, Rr^Pw\o, Rr^Pw\o, Cf, Cf, Cf, Cf, Cf, Cf, Cf, Cf^Efs, Cf, Cf, Cf, Cf, Cf, Cf, Cf, Co, Rr
Rb, Rd, Re, Rp, Rp, Rr^Pw\o, Co, Co, Co, Cf, Cf, Cf, Cf, Cf, Cf, Cf^Efs, Cf, Cf, Cf, Co, Gg, Rr
Rd, Gd^Vo, Rb, Rp, Re, Re, Rd, Rd, Rd, Ko, Co, Cf, Cf, Cf, Cf, Cf, Cf, Cf, Ko, Co, Gs, Gs
Rp, Gd^Es, Rp, Rp, Rp, Gd^Es, Gd^Vo, Rb, Rb, Rd, Rd, Co, Co, Cf, Ko, Co, Co, Co, Co, Gg, Gg, Gg
Rp, Rp, Re, Re, Re, Rp, Rp, Gd^Es, Re, Re, Re, Re, Rd, Co, Cf, Cf, Cf, Co, Co, Gg, Gg, Gg
