Gg^Em, Gs^Fds, Gs^Fds, Gs^Fds, Gs^Fds, Gs^Fms, Gs^Fds, Gg^Em, Gg, Hh, Hh, Mm, Mm, Mm^Xm, Mm^Xm, Mm^Xm, Mm^Xm, Mm^Xm, Mm, Mm, Wo, Wo, Wo, Wo, Wo, Wo, Wo, Mm^Dr, Mm, Mm, Mm^Xm, Mm
Gg, Gg, Gg, Gs^Fms, Gg^Em, Gs^Fms, Gg, Gg, Gg, Hh, Hh, Hh, Hh^Es, Mm^Es, Mm^Es, Mm^Xm, Wwf^Dr, Mm^Es, Wwf, Wwf, Ww, Wo, Wo, Wo, Ww, Wo, Hh^Es, Hh^Es, Mm^Xm, Mm^Xm, Mm, Mm
Gg, Gg, Gg, Gg, Hh, Gg, Gg, Gg^Es, Gs, Gg, Gs, Hh, Gg, Hh^Es, Hh, Hh^Vhh, Mm^Es, Wwf^Es, Hh, Ww, Ww, Ww, Wo, Wo, Wwf, Wwf, Mm^Xm, Mm, Mm, Mm, Mm^Xm, Mm^Xm
Gg, Gg, Gg, Gg, Gg, Hh, Hh^Es, Hh^Es, Mm, Gs^Vc, Hh, Gs, Gg^Edb, Gg, Gg, Hh^Es, Hh, Hh, Ww^Ewl, Ww, Ww, Wo, Wo, Ww, Hh, Mm, Mm, Mm, Mm^Es, Mm, Mm, Mm
Gs^Fds, Gg, Gg, Gg^Efm, Gg, Hh, Hh, Mm, Mm, Mm, Hh, Hh, Gg, Gg, Cer^Edt, Gg, Gg, Gg, Ww, Ww, Wo, Wo, Wo, Ww, Hh, Hh, Hh, Hh^Es, Hh^Es, Hh^Es, Hh, Hh
Gs^Fds, Gs^Fms, Gs^Fds, Gg, Gg^Efm, Gg, Gg, Mm^Es, Hh^Em, Hh^Em, Gs^Fds, Gg^Em, Re, Cer, Cer, Rb, Wwf, Wwf, Ww, Ww, Wo, Wo, Ww, Gg, Gg, Gg, Gg, Hh, Gg, Hh, Gg, Gg
Gs^Fds, Gs^Fds, Gs^Fds, Gg, Gg, Gg^Edb, Gg^Edb, Hh, Hh, Gs^Fms, Hh, Hh, Re, Re, Rb, Rb, Ww, Ww, Ww, Wo, Wo, Wo, Gg, Gg, Gg, Gg, Gg, Gg, Gg^Efm, Gg, Gg, Gg
Gs^Fds, Gs^Fms, Gs^Fms, Gs^Fds, Gs^Fds, Gg^Edb, Gg, Gg, Re, Hh, Re, Re, Rb, Re, Rb, Rb, Ww^Bw\r, Ww, Wo, Wo, Ww, Ww, Gg, Gg, Hh, Hh, Hh, Gg, Gg, Gg^Efm, Gg, Gg
Gs^Fds, Gs^Fms, Gs^Fds, Gs^Fds, Gg, Gg, Gs, Re, Re^Eb, Re, Rb, Re, Rb, Cer, Rb, Ww, Ww, Ww^Bw\r, Ww^Bw\r, Ww, Gg, Gg, Gg, Gg, Hh^Es, Mm, Mm, Hh, Hh, Gg, Gg, Gg
Gs^Fds, Gs^Fms, Gs^Fds, Gs^Fds, Re, Re, Gs, Gg^Edb, Rb, Rb, Cer^Es, Rb, Rb, Cer^Edb, Rb, Ww, Wo, Wo, Ww, Re, Re, Gg, Gg, Gg, Hh^Es, Mm, Mm, Mm, Hh, Gg, Gg, Gg
Gg^Emf, Gs^Fds, Gs^Fds, Gg^Em, Rb, Re, Gs^Fds, Gg^Edb, Gg, Ker, Rb, Rb, Rb, Re, Rb, Wo, Ww, Ww, Gg, Gg, Gs, Gg, Gg, Gg, Gg^Es, Hh, Hh, Hh, Gg, Gg, Hh^Es, Hh^Es
Gg^Em, Gg^Em, Gg, Re, Cer^Edb, Rb, Gs^Fds, Gs^Fms, Gs^Fds, Rb, Cer^Ecf, Rb, Re, Re, Ww, Ww, Ww, Ww^Ewl, Gg^Es, Gs^Vc, Hhd^Vhhr, Hhd, Gg, Gg, Gg, Hh^Edb, Gg^Eff, Gg, Gg, Gg, Hh, Hh^Es
Gg^Em, Gg, Ker, Cer, Cer, Rb, Gs, Gs^Fms, Gs, Gs^Fds, Cer^Edb, Rb, Rb, Rb, Wwf, Ww, Ww, Cer, Gg, Hhd^Es, Re, Gg, Gg, Gg^Wm, Gg, Gg^Eff, Gg^Gvs, Gg^Eff, Gg^Eff, Gg, Gg, Hh
Gg^Em, Gg, Gg^Em, Gg, Gg, Gs, Gs, Gs, Gs, Gs, Gg^Eff, Rb, Ww, Rb, Wwf, Wwf, Re, Rb, Gg, Gg, Rb^Eb, Gg, Gg^Eff, Gg, Gg^Gvs, Gg^Gvs, Gg^Gvs, Gg^Gvs, Gg^Gvs, Gg^Eff, Gg^Eff, Gg
Gg^Emf, Gg^Em, Gs^Fds, Gs^Fds, Gs^Fds, Gg^Edt, Gg, Gg, Gg, Gg^Eff, Wwf, Ww, Ww, Ww, Ww, Wwf, Gg, Re^Edb, Re, Re, Re, Gg^Eff, Gg^Eff, Gg^Gvs, Gg^Gvs, Gg^Gvs, Gg^Gvs, Gg^Gvs, Gg^Eff, Gg^Eff, Gg^Efm, Gg^Efm
Gs^Fds, Gs^Fds, Gs^Fds, Gs^Fms, Gs^Fds, Gs^Fds, Gg, Gg^Edb, Wwf, Wwf, Ww, Ww, Wo, Ww, Ww, Gg, Gg^Efm, Gg^Es, Gg^Eff, Rb, Gg, Re, Gg^Edb, Gg^Eff, Gg^Eff, Gg^Gvs, Gg^Eff, Gg^Eff, Gg, Gg, Gg, Gg
Gs^Fds, Gs^Fms, Gs^Gvs, Gs^Gvs, Gg^Gvs, Gg^Es, Gs^Es, Gg, Ww, Ww, Ww, Wo, Wo, Ww, Gg^Efm, Gg^Efm, Gg^Gvs, Gg^Gvs, Gg^Gvs, Gg^Eff, Gg^Eff, Re, Rb, Re, Re, Gg^Eff, Gg, Gg, Gg, Gg^Es, Gg, Gg
Gs^Gvs, Gs^Gvs, Gs^Gvs, Gg^Gvs, Gs^Gvs, Gs^Gvs, Gg^Eff, Gg^Es, Ww, Ww, Wo, Wo, Ww, Ww^Ewl, Gg^Gvs, Gg^Gvs, Gg^Gvs, Gg^Gvs, Gg^Gvs, Gg^Gvs, Gg^Eff, Gg^Eff, Gg, Rb, Rb, Rb, Gg, Rb^Ebn, Gg, Gg, Gg, Gg^Eff
Gs^Gvs, Gs^Gvs, Gs^Gvs, Gg^Gvs, Gg^Eff, Gg^Eff, Ww, Ww, Ww, Wo, Wo, Ww, Gg^Gvs, Gg^Gvs, Gg^Gvs, Gg^Gvs, Gg^Gvs, Gg^Gvs, Gg^Eff, Gg^Eff, Gg, Gg, Gs^Es, Gg^Edb, Gg, Gg^Edt, Re, Gg, Gg, Gg, Gg, Gg
Gs^Gvs, Gs^Gvs, Gg^Eff, Gg^Eff, Gg^Es, Gg^Efm, Ww, Ww, Wo, Wo, Ww, Ww, Wwf, Gg^Gvs, Gg^Gvs, Gg^Gvs, Gs^Fds, Gg^Eff, Gs^Fds, Gg, Gg, Gs^Vc, Gs^Vc, Gs, Rb^Eb, Gg, Rb, Re, Rb, Gg, Gg, Gg
Gs^Fds, Gs^Fds, Gs^Fds, Gg, Gg, Ww^Ewl, Ww, Ww, Wo, Wo, Ww, Ww, Wwf, Gg, Gg, Gs^Fds, Gs^Fms, Gs^Fms, Gs^Fms, Gs^Fds, Gs^Fds, Gg, Gg, Gs, Gg, Gg, Gg^Efm, Re, Re, Gg, Gg, Gg
Gs^Fds, Gs^Fms, Gs^Fds, Gg, Ww, Ww, Wo, Wo, Ww, Ww, Wwf, Wwf, Wwf, Gg, Gg, Gs^Fds, Gs^Fds, Gs^Fds, Gs^Fds, Gs^Fms, Gs^Fds, Gs^Fds, Gg, Gg, Gg^Efm, Gg^Efm, Gg, Gg, Gg, Re, Gg, Gg
