Mm, Mm, Mm, Mm, Mm, Hh, Hh, Rb, Hh, Hh, Mm^Xm, Hh, Mm, Hh, Mm, Hh, Mm, Gg, Mm, Hh, Mm^Xm, Hh, Wo, Wo, Ww, Mm, Mm, Mm, Mm, Mm, Mm, Mm, Hh, Hh, Hh, Hh, Hh, Hh
Mm, Mm^Xm, Mm^Xm, Mm, Mm, Hh, Rb, Rb, Hh, Mm, Mm, Mm, Mm, Hh, Mm, Mm, Mm, Mm, Mm^Xm, Mm^Xm, Mm, Mm, Wo, Wo, Ww, Mm, Mm, Mm, Hh, Hh, Gg, Hh, Gg, Gg, Gg, Gg, Hh, Hh
Mm, Mm, Mm, Mm^Xm, Mm, Hh, Re, Rb, Hh, Hh, Hh, Mm, Hh, Hh, Hh, Hh, Hh, Mm, Mm, Mm, Hh, Hh, Gg, Wo, Ww, Ww, Gg, Hh, Hh, Gg, Gg, Gg, Hh, Gg, Hh, Gg, Hh, Gg
Mm, Mm, Mm, Mm, Hh, Hh, Re, Rb, Hh, Hh, Gg, Hh, Hh, Gg, Gg, Gg, Gg^Efm, Gg, Gg, Gg, Hh, Hh, Gg, Wo, Wo, Ww, Gg, Hh, Hh, Hh, Hh, Gg, Gg, Hh, Gg, Hh, Gg, Hh
Hh, Hh, Hh, Hh, Hh, Hh, Re, Rb, Gg, Hh, Hh, Ce, Ce, Hh, Gg, Gg, Hh, Gg, Gg, Hh, Hh, Gg, Gg, Gg, Wwr, Ww, Ww, Gg, Gg, Gg, Gg, Gg, Gg, Gg, Gg, Gg, Gg, Gg
Hh, Hh, Hh, Hh, Hh, Hh, Gg, Re, Rb, Ce, Ce, 1 Ke, Ce, Ce, Gg, Hh, Hh, Gg, Ce, Ce, Gg, Gg, Re^Vct, Gg, Gg, Ww, Wo, Ww, Hh, Hh, Gg, Gg, Hh, Gg, Hh, Gg, Gg, Gg
Hh, Hh, Gg, Gg, Hh, Gg, Gg, Re, Re, Hh, Re, Ce, Gg, Ce, Gg, Gg, Gg^Efm, Ce, Ce, 3 Ke, Gg, Gg, Gg, Gg, Gg, Wwr, Ww, Wo, Ww, Gg, Gg, Gg, Gg, Hh, Gg, Hh, Gg, Gg
Gg, Hh, Hh, Hh, Hh, Hh, Hh, Gg, Rb, Rb, Re, Gg, Re^Vct, Gg, Re, Gg, Re, Gg, Gg, Gg, Gg, Gg, Gg, Gg, Gg, Gg, Ww, Wo, Ww, Gg, Gg, Gg, Gg, Gg, Gg, Gg, Gg, Gg
Gg, Gg, Ce, Hh, 2 Ke, Hh, Gg, Gg, Gg, Re, Rb, Re, Re, Re, Gg, Re, Re, Re, Re, Gg, Gg, Gg, Gg, Gg, Gg, Gg, Ww, Wo, Ww, Gg, Gg, Gg, Gg, Gg, Gg, Gg, Gg, Gg
Gg, Gg, Gg, Ce, Ce, Ce, Ce, Gg, Re, Re, Gg, Gg, Gg, Gg, Gg, Gg, Gg^Efm, Gg, Rb, Rb, Rb, Gg, Gg, Gg, Gg, Gg, Ww, Ww, Ww, Wwr, Gg, Gg, Gg, Gg, Gg, Gg, Gg, Gg
Gg, Gg, Re^Vct, Gg, Gg, Gg, Gg, Gg, Re, Gg, Gg, Gg, Gg, Gg, Gg, Gg, Gg^Efm, Gg, Gg, Rb, Re, Gg, Gg, Gg, Gg, Gg, Ww, Ww, Ww, Wwr, Gg, Gg, Gg, Gg, Gg, Gg, Rr, Rr
Gg, Gg, Gg, Gg, Gg, Gg, Re, Re, Rb, Gg, Gg, Gg, Gg, Gg, Gg, Gg, Re, Gg, Gg, Rb, Gg, Re, Re, Gg, Gg, Gg, Ww, Wo, Ww, Wwr, Gg, Gg, Gg, Gg, Rr, Rr, Rb, Gg
Gg, Gg, Gg, Re, Re, Re, Gg, Gg, Gg, Rb, Rb, Re^Vct, Gg, Gg, Re, Re, Gg^Efm, Gg, Gg, Gg, Gg, Rb, Gg, Gg, Gg, Wwr, Ww, Wo, Ww, Ww, Gg, Gg, Rr, Rr, Rr, Gg, Rb, Gg
Gg, Gg, Gg, Gg, Gg, Gg, Gg, Gg, Gg, Gg, Gg, Rb, Gg, Re, Gg, Gg, Gg^Efm, Re^Vct, Gg, Gg, Rb, Rb, Rb, Gg, Gg, Wwr, Ww, Wo, Ww, Ww, Gg, Gg, Rr, Rr, Gg, Rr, Rb, Rr
Gg, Gg, Gg, Gg, Gg, Gg, Rb, Gg, Gg, Gg, Gg, Rb, Rb, Re, Gg, Gg, Gg^Efm, Gg, Gg, Gg, Rb, Rb, Ce, Rb, Gg, Wwr, Ww, Wo, Ww, Ww, Rr, Rr, Gg, Rr, Rr, Rb, Gg, Gg
Gg, Gg, Gg, Gg, Gg, Gg, Gg, Rb, Gg, Gg, Gg, Gg^Efm, Rb, Gg, Gg, Gg^Efm, Gg^Efm, Gg, Rd, Rb, Co, Co^Ecf, Ko, Ce, Rb, Gg, Gg, Ww, Ww^Bsb/, Wo^Bsb/, Wwr, Gg, Gg, Gg, Gg, Rb, Rr, Rr
Gg^Efm, Gg^Efm, Gg, Gg, Gg, Gg, Gg, Rb, Rb, Gg, Gg^Efm, Gg, Re, Re, Gg, Gg, Gg, Gg, Rb, Rb, Rb, Rd, Rb, Rb^Ecf, Gg, Gs, Gg, Rr, Rr, Wwr, Wwr, Gg, Gg, Gg, Gg, Gg, Gg, Rr
Gg, Gg^Efm, Gg, Gg, Gg, Re^Vct, Gg, Gg, Rb, Gg, Gg, Re, Gg, Gg, Gg, Gg, Gg, Gg, Gg, Rd^Ecf, Rr, Rb, Gg, Rb, Gg, Re^Vct, Rr, Rr, Ww, Wo^Bsb\, Wo^Bsb\, Gg, Gg, Gg, Gs, Gg, Gs, Gs
Gg, Gg, Gg, Gg, Gg, Gg, Gg, Gg, Gg, Rb, Rb, Re, Re, Gg, Gg, Gg, Gg, Gg, Gg, Gg, Gg, Rr, Gg, Gg, Rr, Rr, Rr, Gg, Wo, Ww, Gg, Rp, Rp, Gs, Gd, Gs, Gs, Gg
Gg, Gg, Gg, Gg, Gg, Gg, Gg, Gg, Rd, Rb, Re, Re, Rd, Rb, Gg, Re^Vct, Gg, Gg, Gg, Gg, Gg, Rr, Rr, Rr, Gg, Gs, Gg, Gg, Wo, Ww, Gg, Gg, Rp, Rp, Rp, Gd, Gg^Eff, Gg^Eff
Gg, Gg, Gg, Gg, Gg, Gg, Gg, Rd, Rb^Ecf, Re, Co, Co^Ecf, Rd, Re, Gg, Gg, Gs, Gg, Gg, Gg, Gg, Gg, Rr, Rr, Gg, Gg, Gg, Wo, Wo, Ww, Gg, Gg, Gs, Rp, Gs, Gd, Gg^Gvs, Gg^Gvs
Gg, Gg, Gg, Gg, Gg, Gg, Gg, Rd, Rd, Rb, Rb, Rd^Ecf, Re, Re, Rd, Gg, Gs, Gg, Gg, Gs, Gs, Gg, Gg, Rr, Gg, Gg, Gg, Wo, Wo, Ww, Gg, Gg, Gg^Eff, Gg^Eff, Gg^Gvs, Gg^Gvs, Gg^Gvs, Gg^Gvs
Gg, Gg, Gg, Gg, Gg, Gg, Gg, Rd, Rd, Rd, Rb, Rb, Rb, Re, Gg, Gg, Gg, Gs, Gs, Gg, Gs, Gs, Gg, Rr, Gg, Gg, Gs, Ww, Wo, Wo, Ww, Gg, Gg, Gg^Eff, Gg^Eff, Gs^Gvs, Gs^Gvs, Gg^Gvs
Gg^Efm, Gg, Gg, Gg, Gg, Gg, Gg, Gg, Gg, Gg, Gg, Gg, Rr, Gg, Gg, Gg, Gg, Gg, Gg, Gs, Rr, Gs, Rr, Rr, Gg, Gg, Gg, Gs, Gs, Wo, Wo, Wwr, Gg, Gg, Gg, Gs^Vl, Gs^Eff, Gs^Gvs
Gg, Gg^Efm, Gg^Efm, Gg, Gg, Gg, Gg, Gg, Gg, Re^Vct, Gg, Gg, Rr, Gg, Gg, Gg, Gg, Gg, Rr, Rr, Rr, Rr, Gg, Rr, Rr, Gg, Gs, Re^Vct, Gg, Wo, Wo, Ww, Wo, Ww, Ww, Gg, Gs, Gs^Eff
Gg, Gg, Gg, Gg, Gg, Gg, Gg, Gg, Gg, Gg, Gg, Gg, Rr, Rr, Gg, Gg, Rr, Rr, Gg, Gg, Gg, Gg, Re^Vct, Gg, Rr, Gs, Gg, Gs, Gg, Wo, Wo, Wo, Wo, Wo, Wo, Ww, Ww^Em, Gg
Gg, Gg, Gg, Gg, Gg, Gg, Gg, Gg, Gg, Gg, Gg, Gg, Rr, Rr, Rr, Rr, Gg, Gg, Rb, Gg, Rb, Gg, Gg, Gg, Gg, Rr, Rr, Gg, Ww, Ww, Wo, Wo, Wo, Wo, Ww^Ewf, Ww, Ww^Bw/r, Ww^Bw/r
Gg, Gg, Gg, Gg, Re^Vct, Gg, Gg, Gg, Gg, Gg, Gg, Gg, Gg, Rr, Gg, Gg, Rb, Rb, Re, Rb, Rb, Rb, Rd, Gg, Gg, Gg, Rr, Rr, Ww^Ewl, Ww, Wo, Wo, Ww, Wo, Ss^Bw/r, Wo^Bw/r, Wo, Ww
Gg, Gg, Gg, Gg, Gg^Efm, Gg^Efm, Gg^Eff, Gg^Eff, Gg^Eff, Gg, Gg, Gg, Gg, Rr, Gg, Re^Vct, Rb, Gg, Rr, Co, Rd^Ecf, Rd, Rd^Ecf, Rd, Gg, Gg, Gg, Rr, Gs^Vht, Ww, Wo, Ww^Ewl, Ss^Vhs, Ss^Bw/r, Ss^Vhs, Ss, Ss^Em, Wo
Gg, Gg, Gg^Efm, Gg^Efm, Gg^Eff, Gg^Eff, Gg^Gvs, Gg^Gvs, Gg^Gvs, Gg^Eff, Gg^Eff, Gg, Gg, Rr, Rr, Gg, Gg, Rb, Rb^Ecf, Co, Ker, Rd, Rb, Rd, Gg, Gg, Gg, Gg, Wwr, Ww, Wo, Ss^Em, Ss^Bw/r, Ss^Bw|r, Ss^Bw\r, Ss^Em, Ss^Em, Wo
Gg, Gg, Gg, Gg^Eff, Gg^Eff, Gg^Gvs, Gg^Gvs, Gg^Gvs, Gg^Gvs, Gg^Gvs, Gg^Gvs, Gg^Eff, Gg^Eff, Gg, Gg, Rr, Gg, Rb, Rb, Rd, Rb, Rb, Re, Gg, Gg^Efm, Gg, Gg, Gg, Ww, Ww, Wot^Bw/r, Wo^Bw/r, Wo, Ss^Em, Wo, Wo^Bw\r, Wo^Bw\r, Wo
Gg^Efm, Gg, Gg, Gg, Gg, Gg, Gg, Gg^Gvs, Gs^Gvs, Gs^Gvs, Gs^Gvs, Gs^Gvs, Gs^Eff, Gs^Eff, Gs, Rr, Rr, Rd, Rr, Rb, Gg, Gg, Gg, Gg, Gg^Efm, Gg, Gg, Gg, Rb, Ww^Bw/r, Ww, Ww, Ww, Wo, Ww, Ww^Ewf, Ww^Bw|r, Wwr
Gg, Gg, Gg, Gg, Ch, Gg, Gg^Efm, Gs^Eff, Gs^Eff, Gs^Gvs, Gs^Eff, Gs^Vl, Gg, Gg, Gg, Gg, Rr, Rr, Gg, Gg, Gs, Gg, Gs, Gg, Gg^Efm, Gg, Gg, Rr, Gg, Gg, Gg, Wwr, Gg, Ww, Gg, Ww^Em, Rb, Gg
Gg, Gg, Gg, Ch, 6 Kh, Ch, Ce, Gg, Gs, Gs^Eff, Gs, Gs, Gg^Efm, Gg^Efm, Gg, Gg, Rr, Rr, Gs, Gs, Gg, Gs, Gg, Gg, Gg, Gg, Rr, Rr, Rb, Gg, Gg, Gg, Gg^Efm, Gg, Gs, Rb, Gs, Gs
Gg, Gg, Gs^Vh, Gg, Ce, Ce, Gg, Gg, Gg, Gg, Gg, Gg, Gg, Gg, Gg, Gg, Rr, Rr, Gs, Gg, Gs^Vh, Gs, Gg, Gg, Gg, Rr, Rb, Rb, Re, Re, Re, Gg, Gg, Gs^Vh, Gg, Rb, Gg, Gs
Gg, Gg, Gg, Gg, Gg, Gg, Gg, Gg, Gg, Gg, Gg, Gg, Gg, Gg, Gg, Gg, Rr, Rr, Gg, Gs, Gs, Gs, Gg, Gg, Gg, Rr, Rb, Rb, Re, Re, Ch, Rd, Rb, Gg, Gg, Gg, Gg, Gg
Gg, Gg, Gg, Gg, Gg, Gg, Gg, Gg, Gg, Gg, Gg, Gg^Ecf, Gg, Gg, Gg, Gg, Rr, Rr, Gg, Gg, Gg, Gg, Gg, Gg, Gg, Gg, Rr, Rb, Ch, Co, 7 Kh, Co, Re, Rb, Rb, Gg, Gg, Gg
Ch, Ch, Ch, Ch, Ch, Ch, Ch, Gg, 5 Ko, Gg, Gg, Gg, Gg, Gg, Kh, Rr, Rr, Rr, Gg, Gg, Gg, Gg, Gs^Vh, Gg, Gg, Gg, Gg, Re, Re, Ch, Rr, Co, Re, Re, Rb, Gg, Rr, Rr
Ce, Ce, Ce, Ce, Ce, Ce, Ce, Ce, Rrc, Co, Co, Gg, Ce, Co, Ch, Rrc, Rrc, Rr, Ch, Ch, Ch, Gg, Gg, Gg, Gg^Ecf, Gg, Rr, Rb, Rb, Re, Rb, Rd, Gg, Re, Gg, Gg, Gg, Gg
Rrc, Rrc, Rrc, Rrc, Rrc, Rrc, Rrc, Rrc, Rrc, Rrc, Rrc, Ce, Ch, Ch, Rd, Rd, Rr^Vhc, Rrc, Rrc, 4 Kh, Ce, Gg, Rr, Gg, Rr, Rr, Rr, Rr, Gg, Rb, Gg, Rb, Gg, Gg, Gg, Rr, Rr, Gg
Rd, Rd, Rd, Rd, Rd, Rd, Rd, Rd, Rd, Rrc, Rr, Rrc, Rrc, Rd, Rr, Rr, Rr, Rr, Rd, Rrc, Rr, Rr, Rr, Rr, Rr, Rr, Gg, Gs, Gs, Gs, Gs, Gs, Gg, Gg, Gg, Gg, Gg, Rr
Rrc, Rrc, Rrc, Rrc, Rr^Vhc, Rrc, Rrc, Rd, Rr, Rr, Re^Ebn, Rd, Rrc, Rrc, Rrc, Rrc, Rd, Rrc, Rrc, Rrc, Rrc, Rr, Ch, Ch, Ch, Rr, Rr, Gs, Gg, Gs^Vh, Gs, Gg, Gg, Gg, Rr, Rr, Gg, Gg
Rr, Rr, Rr, Rr, Rr, Rr, Rr, Rr, Rrc, Rr, Re, Rd, Rr^Vhc, Rrc, Rd, Rd, Rrc, Rd, Rd, Rrc, Rd, Rrc, Rrc, 8 Kh, Ch, Gg, Gg, Rr, Rr, Gg, Gg, Gg, Rr, Rr, Gg, Rb, Co, Rb
Rr, Rr, Rr, Rr, Rr, Rr, Rr, Rr, Rr, Rr, Rd, Rd, Rrc, Rr, Rd, Rrc, Rrc, Rr^Vhc, Rr, Rd, Rr, Rrc, Rrc, Ch, Gg, Gg, Gg, Rr, Rr, Rr, Rr, Gg, Rb, Rb, Rd, Ko, Co, Rd
