Gll^Fdf, Gll^Fdf, Gll^Fdf, Gll^Fdf, Gll^Fdf, Gll^Fdf, Gll^Fdf, Gll^Fdf, Gll^Fmf, Gll^Fmf, Gll^Fmw, Gll^Fmw, Gll^Fmf, Gll^Fmf, Gll^Fmf, Gs, Gll^Fdf, Gg, Gg, Gg, Gll^Fdf, Gll^Fdf, Gll^Fdf, Gll^Fdf, Gll^Fdf, Gll^Fdf, Gll^Fmf, Gll^Fmf, Gll^Fmf, Gll^Fmf, Gll^Fmf, Gll^Fmf
Gll^Fdf, Gll^Fdf, Gll^Fdf, Gll^Fdf, Gll^Fdf, Gll^Fdf, Gll^Fdf, Gll^Fdf, Gll^Fmw, Gll^Fmw, Gll^Fdf, Gll^Fmf, Gll^Fdf, Gll^Fmf, Gll^Fdf, Gs, Gg, Gg, Gg, Gg, Gll^Fdf, Gll^Fdf, Ce, Gll^Fdf, Gll^Fmw, Gll^Fdf, Gll^Fmw, Gll^Fmf, Gll^Fmf, Gll^Fmf, Gll^Fmw, Gll^Fmw
Gll^Fmf, Gll^Fdf, Gll^Fmf, Gll^Fdf, Gll^Fdf, Gll^Fdf, Gll^Fmw, Gll^Fmw, Gll^Fmf, Gll^Fdf, Gll^Fmf, Gll^Fmf, Gll^Fmw, Gll^Fmf, Gll^Fmf, Gg, Gg^Fet, Ce, Ce, Gll^Fmw, Gll^Fmw, Ce, Ce, Ce, Gll^Fmw, Gll^Fmw, Gll^Fmf, Gll^Fmf, Gll^Fmw, Gll^Fmw, Gll^Fmw, Gll^Fmw
Gll^Fmf, Gll^Fmf, Gll, Gll^Fmf, Gll^Fmw, Gll^Fmw, Gd, Gll^Fdf, Gs, Gll^Fmf, Gll, Gll, Gll, Gll, Gll, Gll, Gs, Gg, Ce, Gll^Fmw, 1 Ke, Ce, Gll^Fmf, Gll^Fmw, Gll^Fdf, Gll^Fmf, Gll^Fmw, Gll^Fmw, Gll^Fmf, Gll^Fmf, Gll^Fdf, Gll^Fmw
Gll, Gll, Gll, Gll^Fmw, Gll^Fdf, Gd, Gd, Gd, Gd, Gs, Gs, Gll^Fmw, Gll^Fdf, Gll^Fdf, Gg, Gll^Dr, Gs^Vc, Gg, Gll^Fdf, Ce, Ce, Gll^Fdf, Gll^Fdf, Gll^Fdf, Gs, Gll^Fmw, Gll^Fdf, Gll^Fdf, Gll^Fdf, Gll^Fmf, Gll^Fmf, Gll^Fdf
Gll, Gll, Gll, Gll^Fmw, Gll^Fmw, Gll^Fdf, Gll^Fmf, Gd, Gs, Gs, Gll^Fdf, Gll^Fdf, Gll^Fdf, Gll^Fdf, Gg, Gg, Rp, Gs, Gll^Fmw, Gll^Fmw, Gll^Fdf, Ce, Gll^Fmw, Gs, Gs, Gs, Rp, Gll^Fdf, Gll^Fmf, Gll^Fmf, Gll^Fmf, Gll^Fdf
Gll^Fdf, Gll, Gd, Gll^Fdf, Gll^Fdf, Gll^Fmw, Gs, Gd, Gd, Gs, Gll^Fdf, Gll^Fdf, Gll^Fdf, Gll^Fdf, Gg, Gll^Fdf, Rp, Gs, Rp, Gll^Fdf, Gll^Fdf, Gll^Fdf, Gs, Rp, Rp, Rp, Gll^Fmw, Gll^Fmf, Gll^Fmf, Gll^Fmf, Gll^Fmf, Gll^Fmf
Wwf, Wwf, Gll^Fmf, Gll^Fdf, Gll^Fdf, Gll^Fdf, Gs^Vc, Gs, Gs, Gd, Gll^Fdf, Gll^Fdf, Gll^Fmf, Gll^Fdf, Gll^Fmw, Gg, Rp, Rp, Gg, Gll, Gll^Fdf, Gll^Fdf, Gll^Fmw, Rp, Rd, Gll, Gll, Gll^Fdf, Gll^Fmw, Gll^Fmf, Gll^Fmf, Gll^Fdf
Ww, Wwf, Gll^Fdf, Gll^Fmf, Gll^Fmw, Gll^Fmw, Gll^Fmw, Rp, Rp, Gll^Fdf, Gll, Gll, Rd, Gll^Fmw, Gg, Gs, Gs, Gs, Gll, Gll^Fdf, Gll, Gll^Fmw, Gll^Fmw, Gll^Fmw, Gll^Fdf, Rd, Rd, Rd, Rd, Gll^Fdf, Rd, Gll^Fdf
Ww, Ww, Wwf, Gll^Fmw, Gll^Fdf, Gll^Fmw, Gll, Gll, Rp, Gll, Rd, Rd, Gd, Gll^Fdf, Gg, Gs, Gs, Gs, Gll^Fdf, Gll^Fdf, Gll^Fdf, Gll, Gll, Gll^Fdf, Gll^Fdf, Gll^Fdf, Gll^Fmf, Gll^Fdf, Gll^Fmw, Rd, Gd, Rd
Ww, Ww, Wwf, Wwf, Gll^Fdf, Gll^Fmw, Rd, Rd, Rd, Rp, Gd, Gd, Gs, Gs, Gs, Gs, Rp, Gll, Gll^Fmf, Gll^Fdf, Gll, Gll, Gll, Gll, Gll, Gll^Fdf, Gll^Fmw, Gll^Fmw, Gll^Fmw, Gll^Fmw, Gll^Fdf, Gll
Ww, Ww, Ww, Ww, Rd, Gll^Fdf, Rp, Rp, Gs, Gd, Gs, Gs, Rp, Rp, Rp, Rp, Rp, Rp, Rp, Rp, Rp, Rp, Gs^Vc, Gll, Gll, Gll, Gll^Fmw, Gll^Fmw, Gll^Fdf, Gll^Fdf, Gll^Fdf, Gll^Fdf
Ww, Ww, Gll, Gll, Rd, Rp, Gs, Gs^Dr, Gd, Gd, Gd, Rp, Rp, Gs, Gd, Rd, Gd, Gd, Gll^Fmw, Gll^Fdf, Gd, Gd, Rp, Gll, Gll^Fmw, Gll^Fmw, Gll^Fmf, Gll^Fdf, Gll^Fdf, Gll^Fdf, Gll^Fdf, Gd
Ww^Bw/r, Ww^Bw/r, Rd, Gll^Fdf, Gd, Gd, Gd, Gd, Gd, Gd, Rp, Rp, Rd, Gll^Fdf, Rd, Gd, Gll^Fmw, Gd, Gll, Gll^Fmf, Gll^Fdf, Gs, Gs, Rp, Rp, Gll^Fmw, Gll^Fmf, Gll^Fdf, Rd, Rd, Rd, Gs
Ww, Wo, Gll, Gll, Gd, Gd, Gs, Gs, Gd, Gll, Hhd, Rd, Hhd, Gll^Fdf, Rd, Rd, Gll, Gll, Gll^Fdf, Gll^Fdf, Gll^Fmw, Gll^Fmw, Gs, Gll, Gll, Gll^Fmw, Rd, Gs, Gll^Fdf, Gs, Gll^Fdf, Gll
Ww, Wo, Ww, Gs, Rp, Rp, Gd, Gd, Hhd, Gll, Hhd, Hhd, Mm, Gll^Fdf, Gll^Fdf, Gll^Fdf, Gll^Fdf, Gll^Fdf, Gll^Fmw, Gll^Fmw, Gll^Fdf, Gs, Gll, Gs, Rp, Gll^Fmw, Rd, Gs, Gll^Fmf, Gll^Fdf, Gll^Fdf, Gll^Fdf
Ww, Ww, Ww, Gd, Rp, Rp, Hhd, Hhd, Hhd^Vhhr, Hhd, Hhd, Mm, Mv, Mm, Gll^Fmf, Gll^Fdf, Gll^Fmw, Gll^Fmw, Gll^Fdf, Gll^Fdf, Gll^Fdf, Gll^Fdf, Gll^Fdf, Gll, Gll, Rd, Gll^Fmf, Gll^Fdf, Gll^Fdf, Gll^Fmf, Gll^Fmf, Gll^Fdf
Wo, Ww, Ww, Ww, Gll^Dr, Rd, Rd, Hhd, Hhd, Hhd, Hhd, Mm, Mm, Mm, Gll^Fdf, Gll^Fmw, Gll^Fmw, Gll^Fdf, Gll^Fmf, Gll^Fdf, Gll^Fdf, Gll^Fdf, Gll, Gll, Gd, Gll^Fmf, Gll^Fmf, Gll^Fdf, Gll^Fdf, Gll^Fdf, Gll^Fdf, Gll^Fdf
Wo, Ww, Ww, Wwf, Gll, Gll, Gll, Rd, Rd, Hhd, Mm, Mm, Hhd^Dr, Hhd, Wwf, Wwf, Ww, Ww, Ww, Gll^Fmf, Gll^Fmf, Gll^Fdf, Gd, Gd, Gll^Fdf, Gll^Fdf, Gll^Fdw, Gll^Fmf, Gll^Fdf, Wwr, Wwr, Wwr
Ww, Ww, Ww, Gd, Rd, Gs^Vc, Gd, Gd, Gll, Hhd, Hhd, Hhd, Hhd, Hhd, Gll^Fmw, Gll^Fdf, Gll^Fdw, Wwr, Gll^Fdf, Ww, Wwr, Gd, Gd, Gd, Gll, Gll^Fdf, Gll^Fdw, Gll^Fdf, Gll^Fmf, Gll^Fmw, Wwr, Ww^Ewf
Wwf, Ww, Gll, Rd, Gd, Gd, Gd, Gd, Gd, Gll, Gd, Gll^Fdf, Gd, Hhd, Gll^Fdf, Gll^Fdf, Gll^Fdf, Gll^Fdw, Gll^Fdw, Ww, Ww, Ww, Ww, Gll, Gd, Gll, Gll, Gll^Fdw, Gll^Fdw, Gll^Fmf, Ww, Ww
Ss, Wwf, Gd, Gd, Gll^Fdf, Gll^Fmf, Gll, Gll, Rp, Gd, Gll, Gd, Gll, Re, Re, Re, Re, Gll^Fmf, Gll^Fmf, Gll^Fdf, Gll^Fdf, Wo, Wo, Ww, Wwf, Wo, Wwr, Gll^Fdf, Gll^Fdf, Gll^Fmw, Ww, Ww
Ss, Wwf, Rd, Gll^Fdw, Gll^Fdf, Gll^Fdw, Gll, Gll, Gll, Re, Re, Gll, Rd, Gll, Gd, Gd, Gd, Re, Gd, Gll^Fmf, Gll^Fdf, Gll^Fmw, Gd, Wo, Gd, Ww, Gll^Fmw, Wwf, Gll^Fmw, Wwf, Wo, Ww
Sm, Sm, Rd, Gll^Fdw, Gll^Fdw, Gll^Fdw, Gs, Gll, Gll, Rp, Rp, Re, Re, Gd, Rd, Rd, Rd, Rd, Rd, Gd, Rd, Gll^Feth, Gd, Gd, Gll, Gll^Fdf, Gll^Fmw, Gll^Fmw, Gll^Fdf, Gll^Fdf, Ww, Wo
Ss, Sm, Rd^Em, Rd, Rd, Gll^Fdw, Gll^Fdw, Gs, Gs, Gll, Rd, Rp, Rd, Re, Re, Re, Gll, Gll, Gll, Re, Re, Rd, Gll, Gll^Fdw, Gll^Fdw, Gll, Gll, Gll^Fdf, Gll^Fdf, Gll^Fdf, Ww, Ww
Ss, Ss, Gll^Fdw, Rd, Rd, Rd, Gll^Fmf, Gll^Fdw, Gll^Fdw, Gs, Hhd, Rd, Rd, Gll^Fmw, Gll^Fdf, Gll, Gll, Re^Vct, Rp, Gll, Gd, Re, Re, Gll, Gll^Fdw, Gll^Fdw, Gll^Fdw, Gll^Fdf, Gll^Fdf, Gll^Fdf, Wwr, Ww
Gll, Ur, Ur, Ur, Uhe, Gll, Hhd, Gll^Fdf, Hhd, Hhd^Vhhr, Gll^Fdw, Gll^Fdw, Gll^Fdf, Gll^Fdf, Gll^Fdf, Gll, Gll, Gll^Edb, Gd, Gd, Gll^Fdf, Gll^Fdw, Gll, Rb, Re, Gll^Fdw, Gll^Fdf, Gll^Fdw, Gll^Fdw, Gll^Fmf, Wwr, Ww
Gll^Fdw, Ur, Uhe, Uhe, Ur, Ur, Ur, Hhd, Uhe, Uhe, Gll^Fdw, Gll^Fdw, Gll^Fdw, Gll^Fdf, Gll^Fdf, Gll^Fdf, Gll^Fdw, Gll, Gd, Gd, Gd, Gll^Fdw, Rb, Rb, Gll, Rb, Rb, Gll^Fmf, Gll^Fmf, Gll^Fdw, Gll^Fdw, Wwf
Uhe, Uhe, Ur, Ur, Uhe^Edb, Ur, Gll^Fdw, Ur, Ur^Edb, Uhe, Uhe, Gll^Fdw, Gll^Fdw, Gll^Fdw, Gll^Fdw, Gll^Fdw, Gll^Fdw, Gd, Gd, Gd, Rp, Rb, Rb, Rb, Rd, Rb^Edb, Rb, Gll^Fdf, Gll^Fdw, Gll^Fdf, Gll^Fmf, Gll^Fdw
Uu^Vu, Uhe, Gll^Fdf, Ur, Uhe^Edb, Gll^Fdw, Rb, Ur^Edb, Ur^Edb, Ur, Gll^Fdw, Gll^Fdw, Gll^Fmf, Gll^Fdw, Gll^Fdw, Gll^Fdw, Gll^Fdw, Gll^Fdf, Gll^Fdf, Rb, Gll, Re, Rb, Rd^Ecf, Rb, Re^Vct, Rb, Rb, Gll^Fdw, Gll^Fdf, Gll^Fmf, Gll^Fmf
Ur^Edb, Ur^Edb, Rb^Edb, Gll^Fdf, Rb^Edb, Uhe^Edb, Gll^Feth, Gll^Fdw, Gll^Fdw, Ur, Rb^Edb, Rb^Edb, Rb^Edb, Rb^Edb, Rb^Edb, Gll^Fdf, Gll, Gll^Fdw, Rb, Re, Re, Re, Gll, Rb, Gll^Fdf, Rb, Gll^Fdw, Gll^Fdw, Gll^Fdw, Gll^Fdw, Gll^Fdw, Gll^Fdw
Rb^Edb, Rb^Edb, Rb^Edb, Gll^Fdf, Rb^Edb, Gll, Gll, Gll, Rd, Gll, Rd, Rd^Ecf, Rd, Rb^Edb, Rd, Rd, Rb, Rb, Re, Rb, Gll^Fdw, Rb, Gll^Fmf, Gd^Fetd, Gll^Fdf, Gll^Fdf, Gll^Fdf, Gll^Fdw, Gll^Fdw, Gll^Fdw, Gll^Fdw, Gll^Fdw
Ias, Ias, Ias, Rb^Edb, Rb^Edb, Rb^Edb, Rb^Edb, Rd, Rb^Edb, 2 Gll, Rb^Edb, Rb^Edb, Rb^Edb, Rb^Edb, Sm, Sm, Ss, Gll, Gll^Fdw, Gll^Fdw, Gll^Fdf, Gll^Fdw, Gll^Fdw, Gll^Fdf, Gll^Fdw, Gll^Fdf, Gll^Fdw, Gll^Fdw, Gll^Fdf, Gll^Fdf, Gll^Fdf, Gll^Fdf
Ias, Ias, Gd, Ias, Ias, Ias, Rb^Edb, Rb^Edb, Rb^Edb, Rb^Edb, Uhe, Uhe^Edb, Uhe, Sm, Ss^Vhs, Ss, Chs, Ss, Ur, Ur, Ur, Gll^Fdf, Gll^Fdw, Gll^Fdw, Gll^Fdw, Gll^Fdw, Gll^Fdf, Gll^Fdf, Gll^Fdf, Gll^Fdf, Gll^Fdf, Gll^Fdf
Ias, Gd^Fetd, Gd, Gd, Gd, Ias, Rb^Edb, Rb^Edb, Uhe, Ur^Edb, Ur^Edb, Ur^Edb, Ur^Edb, Uhe, Uhe, Ss, Chs, Ss, Ur, Uu^Vu, Uu, Gll^Fdw, Gll^Fdw, Gll^Fdw, Rd, Gll^Fdf, Rd, Rd, Gll^Fdw, Gll^Fdf, Gll^Fdw, Gll^Fdf
Uhe^Edb, Uhe^Edb, Uhe^Edb, Gd, Gll^Feth, Gll, Gll^Fdf, Uhe^Edb, Ur^Edb, Ur^Edb, Ur^Edb, Ur^Edb, Uhe, Ur^Edb, Ss, Chs, Sm, Sm, Ur, Uu, Gll^Fdw, Gll^Fdw, Gll^Fdf, Rd, Gll^Fdf, Rd, Gll^Fdw, Gll^Fdw, Gll^Fdf, Gll^Fdf, Gll^Fdw, Gll^Fdw
Ss, Ias^Edb, Ias^Edb, Uhe^Edb, Gll, Gll, Rb^Edb, Uhe, Uhe, Rb, Uhe, Uhe, Ur^Edb, Sm, Ss, Khs, Gll^Fdw, Ur, Gll^Fdw, Gll^Fdw, Gll^Fdw, Gll^Fdw, Gll^Fdw, Gll^Fdf, Gll^Fdw, Gll^Fdf, Gll^Fdw, Gll^Fdf, Gll^Fdf, Gll^Fdf, Gll^Fdf, Gll^Fdw
Chs, Ss, Sm, Ias^Edb, Ias^Edb, Rb^Edb, Rb^Edb, Rb^Edb, Rb^Edb, Uhe, Ur^Edb, Ur^Edb, Sm, Sm, Ss, Gll^Fdw, Gll^Fdw, Gll^Fdw, Gll^Fdw, Gll^Fdw, Gll^Fdw, Gll^Fdw, Gll^Fdw, Gll^Fdw, Gll^Fdw, Gll^Fdw, Gll^Fdw, Gll^Fdw, Gll^Fdw, Gll^Fdf, Gll^Fdf, Gll^Fdf
Chs, Chs, Chs, Sm, Sm, Rb^Edb, Uu^Edb, Rb^Edb, Gll^Fdw, Rb^Edb, Ur^Edb, Ur^Edb, Sm, Sm, Sm, Gll^Fdw, Gll^Fdf, Gll^Fdw, Gll^Fdf, Gll^Fdw, Gll^Fdw, Gll^Fdw, Gll^Fdw, Gll^Fdw, Gll^Fdw, Gll^Fdw, Gll^Fdf, Gll^Fdw, Gll^Fdw, Gll^Fdw, Gll^Fdw, Gll^Fdw
Uhe^Edb, Chs, Chs, Chs, Uhe^Edb, Uu^Vu, Uhe^Edb, Uhe^Edb, Uhe^Edb, Uhe^Edb, Gll^Fdf, Gll^Fdf, Sm, Sm, Gll^Fdf, Gll^Fdw, Gll^Fdf, Gll^Fdf, Gll^Fdf, Gll^Fdf, Gll^Fdf, Gll^Fdw, Gll^Fdf, Gll^Fdw, Gll^Fdf, Gll^Fdw, Gll^Fdf, Gll^Fdf, Gll^Fdw, Gll^Fdw, Gll^Fdw, Gll^Fdw
Uhe^Edb, Chs, Uhe^Edb, Uhe^Edb, Ur^Edb, Uhe^Edb, Gll^Fdf, Gll^Fdf, Gll^Fdw, Gll^Fdf, Gll^Fdw, Gll^Fdw, Gll^Fdf, Gll^Fdf, Gll^Fdf, Gll^Fdf, Gll^Fdf, Gll^Fdf, Gll^Fdw, Gll^Fdw, Gll^Fdw, Gll^Fdf, Gll^Fdw, Gll^Fdf, Gll^Fdf, Gll^Fdf, Gll^Fdw, Gll^Fdw, Gll^Fdw, Gll^Fdw, Gll^Fdw, Gll^Fdw
Gll^Fdw, Gll^Fdw, Gll^Fdw, Ur^Edb, Ur, Gll^Fdf, Gll^Fdw, Gll^Fdw, Gll^Fdw, Gll^Fdw, Gll^Fdw, Gll^Fdw, Gll^Fdf, Gll^Fdf, Gll^Fdf, Gll^Fdf, Gll^Fdw, Gll^Fdw, Gll^Fdw, Gll^Fdw, Gll^Fdw, Gll^Fdw, Gll^Fdf, Gll^Fdf, Gll^Fdf, Gll^Fdf, Gll^Fdw, Gll^Fdw, Gll^Fdw, Gll^Fdw, Gll^Fdw, Gll^Fdw
