Md^Xm, Md^Xm, Md^Xm, Md^Xm, Md^Xm, Md^Xm, Mm, Md^Xm, Md^Xm, Md^Xm, Re, Md^Xm, Mm, Hhd, Md^Xm, Md^Xm, Md^Xm, Hhd, Md^Xm, Md^Xm, Mm, Ce, Ce, Md^Xm, Hh^Es, Hh^Es, Gg, Gg, Wwf, Wog, Wwt, Wog, Wwt, Rd, Gs^Fds, Gg, Rp, Rp
Md^Xm, Mm, Hhd^Vhhr, Md^Xm, Hh, Mm, Ce, 2 Ke, Hhd, Hhd, Rp, Mm, Hh, Hhd, Hh, Md^Xm, 1 Ke, Ce, Ce, Hh, Hh, Hhd^Vhhr, Ce, Ce, Ce, Gg, Wwf, Wwf, Wwf, Wog, Wwt, Wwt, Wwf, Rd, Gs^Fds, Gg, Rp, Gg
Md^Xm, Hh, Hhd, Hhd, Hhd, Hhd, Ce, Ce, Ce, Rb, Rp, Rb, Rp, Rp, Ce, Ce, Md^Xm, Ce, Hh, Hh, Mm, Mm, Hh^Es, 3 Ke, Ce, Ce, Gg, Wwf, Wog, Wwf, Wwf, Wwt, Wwf, Rd, Gs^Fds, Gg, Rp, Gg
Md^Xm, Hhd, Md^Xm, Rb, Rb, Rb, Ce, Ce, Rb, Rb, Rp, Rp, Rb, Hhd, Mm, Mm, Mm, Mm, Hh, Mm, Mm, Mm, Hh^Es, Gg, Rp, Rp, Gg, Ds^Esd, Wog, Wog, Wwt, Wwf, Rp, Rd, Rp, Rp, Gg, Gg
Md^Xm, Hhd, Hh, Md^Xm, Hh, Hh, Md^Xm, Hh, Mm, Rb, Rp, Rb, Mm, Hhd, Md^Xm, Md^Xm, Hhd^Vhhr, Mm, Hh, Hh, Hh, Mm, Hh^Es, Gg, Rp, Gg, Gs^Fms, Ds^Esd, Wog, Wog, Wog, Wwf, Ds^Esd, Rp, Gg, Rp, Gg, Gg
Mm, Mm, Mm, Hh, Md^Xm, Mm, Mm, Mm, Mm, Rb, Rb, Rp, Mm, Mm, Mm, Md^Xm, Md^Xm, Hh, Mm, Mm, Rp, Hh^Es, Rp, Rp, Gs^Fms, Gs^Fms, Rd, Wwt, Wog, Wog, Wwf, Ds^Esd, Gs^Fds, Gs^Fds, Gs^Fds, Gg, Gs^Fds, Gg
Md^Xm, Mm, Mm, Hh, Hh, Md^Xm, Hhd^Vhhr, Mm, Mm, Hhd, Hhd, Rp, Rp, Mm, Rp, Rp, Rp, Rp, Rp, Rp, Hh^Es, Hh^Es, Hh^Es, Gs^Fms, Gs^Fms, Rd, Wwt, Wwt, Wog, Wog, Wwf, Ds^Esd, Gs^Fds, Gs^Fds, Gg, Gs^Fds, Gs^Fds, Gg
Md^Xm, Md^Xm, Mm, Mm, Md^Xm, Hh, Mm, Hhd, Hhd, Mm, Hhd, Rb, Re, Mm, Rp, Rp, Gg, Gg, Gg, Hh^Es, Mm^Xm, Mm, Gs^Fms, Gs^Fms, Gg, Gg, Wwt, Wog, Wog, Wog, Wwt, Ds^Esd, Gg, Gg, Gg, Gs^Fds, Gg, Gg
Md^Xm, Mm, Mm, Mm, Mm, Md^Xm, Mm, Mm, Mm, Hhd, Md^Xm, Hhd, Hhd, Re, Re, Mm^Xm, Mm^Xm, Hh, Mm^Xm, Mm^Xm, Mm, Mm, Gs^Fms, Gg, Gg, Ds^Esd, Wwt, Wog, Wog, Wog, Wog, Wwt, Gs^Fds, Gs^Fds, Gs^Fms, Rp, Rp, Hh
Md^Xm, Mm, Mm, Mm, Md^Xm, Md^Xm, Md^Xm, Mm, Md^Xm, Md^Xm, Mv^Dr, Md^Xm, Md, Re, Re, Hhd, Mm^Xm, Mm^Xm, Mm, Mm, Mm, Mm, Gs^Fms, Gg^Es, Gg, Ds^Esd, Ww^Ewl, Wog, Wwt, Wog, Wwt, Gs^Fds, Gs^Fds, Gs^Fds, Rp, Rp, Gg, Gg
Md^Xm, Md^Xm, Md^Xm, Md^Xm, Md^Xm, Md^Xm, Md^Xm, Md^Xm, Md^Xm, Mm, Mm, Mm, Gll^Fmw, Hhd^Es, Re, Mm^Xm, Mm, Mm, Hhd, Hhd, Rp, Hh^Fms, Rp, Gs^Fms, Gg, Ds, Gg, Wwr, Wwf, Wwt, Wwf, Ds^Esd, Rd, Gg, Gg^Es, Rp, Rp, Gg^Es
Md^Xm, Md^Xm, Md^Xm, Md^Xm, Md^Xm, Md^Xm, Md^Xm, Md^Xm, Md^Xm, Md^Xm, Hhd, Gll^Fmw, Cfr, Hhd^Vhhr, Rr, Re, Rb, Rb, Rp, Rp, Mm, Rp, Mm, Rp, Rp, Gg, Rp, Wwf, Wwf, Wwf, Wwf, Wwf, Wwrt, Gg, Rd, Gg, Gg^Efm, Rp
Hh, Hh, Hh, Hh, Hh, Hh, Hh^Fms, Hh, Hh, Md, Mm, Mm^Xm, Cfr, Kfr, Cfr, Rr, Rr, Rp, Mm, Mm, Gs^Vh, Hh, Mm, Mm, Rp, Rp, Gg^Es, Chr, Chw, Wwf, Ww, Ww, Ww, Ww^Ewl, Gs^Fms, Rd, Gs, Gg^Efm
Hhd, Hhd, Hh^Fms, Gg, Gs^Fds, Hh^Fms, Hh^Fms, Gg, Hhd, Mm, Mm, Cfr, Gg, Cfr, Hh, Hh, Mm^Xm, Rr, Rr, Mm, Mm, Mm, Gs^Fms, Rp, Rr, Hh, Hh, Hh, Wwf, Wwf, Ww, Wog, Wo, Ww, Ds, Rd, Rd, Gs^Fms
Hh, Gg, Gs^Fds, Hh^Fms, Hh^Fms, Hh, Gs^Vc, Gs^Fds, Hh, Hhd^Es, Gs^Fds, Hhd^Es, Hh, Hh, Hh, Mm, Mm, Mm, Rr, Hh, Gs^Fms, Gs^Fms, Gg^Es, Rp, Rr, Hh^Fms, Hh, Hh, Ww, Ww, Wog, Wog, Wog, Ww, Ww, Gg^Es, Gg^Efm, Rd
Hhd, Hh^Fms, Gg, Hhd, Hhd, Gg, Gg, Gs^Fds, Hhd, Hh, Hh, Hh, Hh, Mm, Hh, Hh, Gg^Es, Gg, Rp, Rr, Rrc, Rrc, Hh, Rr, Rr, Rp, Gs^Fms, Ww, Ww, Wog, Wo, Wo, Wo, Ww, Ww, Ds, Gg, Gs
Gg, Gg, Sm, Ss, Ss, Gg, Gg, Gg, Gg, Hh^Fms, Gs^Fms, Gs^Fds, Gg, Gg, Gg, Hh, Hh, Hh, Gs^Fds, Gg, Gg, Rrc, Rrc, Gs^Fms, Rr, Gs^Fms, Gs^Fms, Ds, Ww^Ewl, Wog, Wog, Wo, Wog, Ww, Ww, Ds^Esd, Gg, Gg^Es
Gg, Gg, Gg, Sm, Sm, Ss, Ss, Gg, Gg, Gs^Fms, Gs^Fds, Gg^Es, Ss, Gs^Fds, Gs^Fds, Gg, Hh, Gs^Fms, Gs, Gg, Gg^Es, Gs, Gs, Rrc, Rr, Gg, Gg, Wwf, Wwf, Wo, Wo, Wo, Wog, Wo, Ww, Wwr, Gg, Gg^Efm
Ss, Ss, Wwf, Ss, Ss, Ss, Gg, Ss, Ss, Gs^Fms, Wwf, Ss, Sm, Ss, Wwf, Gg, Khs, Gg, Hh^Fms, Hh, Gs, Gg, Wwf, Gs, Wwf^Bw|r, Gg^Es, Wwf, Wwf, Ds^Esd, Ww, Ww, Wo, Wo, Wo, Ww, Ds, Ds, Gg^Efm
Ss, Ss, Wwf, Sm, Sm, Ss, Wwf, Ss, Wwf, Ss, Ss^Vhs, Wwf, Ss, Wwf, Ss, Wwf, Sm, Chs, Hh^Fms, Hh, Wwf, Wwf, Rp, Wwf, Rr, Wwf, Gs, Gg^Es, Gg, Ds, Ww, Wo, Wo, Wo, Sm, Ww, Ww, Gs^Fds
Ss, Ss^Vhs, Ss, Wwf, Wwf, Wwf, Ss, Wwf, Ss, Wwf, Sm, Sm, Wwf, Ss, Wwf, Ss, Chs, Chs, Gg, Wwf, Rr, Rr, Rr, Rp, Gg^Es, Rr, Rr, Hh^Es, Hh, Ds^Esd, Ww, Wo, Wo, Wo, Sm, Sm, Sm, Gs
Sm, Ss, Wwf, Wwf, Gg, Hh, Hh, Hh, Hh, Gg, Gg^Es, Ss, Ss, Wwf, Sm, Wwf, Chs, Gg, Rr, Wwf, Gs, Rr, Rrc, Re^Gvs, Re^Gvs, Rr, Rr, Hh, Hh, Ds, Ww, Wo, Wo, Wo, Wo, Sm, Ww, Sm
Sm, Ss, Sm, Wwf, Ss, Gg, Gg, Hh, Hh, Hh, Gg, Gs, Gg^Es, Gg, Rp, Rp, Rp, Chs, Wwf, Wwf, Gs, Rrc, Gg^Em, Re^Gvs, Rr^Vhc, Gg^Em, Re^Gvs, Rp, Rrc, Gs, Sm, Sm, Wo, Wo, Wo, Wo, Ww^Ewf, Ww
Gg, Sm, Ss, Wwf, Wwf, Ss, Ss, Ss, Gg, Gg^Es, Re^Gvs, Re^Gvs, Re^Gvs, Gg^Wm, Gg, Rr, Rr, Gs, Gg, Gs, Rr, Rrc, Gg^Em, Gg^Emf, Re^Gvs, Re^Gvs, Re^Gvs, Gg^Wm, Rrc, Rr, Ww^Ewl, Ww, Wo, Wo, Sm, Sm, Ss^Bsb/, Wo^Bsb/
Ss, Ss, Gg, Gg, Gg, Gg, Gg, Gg, Gg, Re^Gvs, Re^Gvs, Re^Gvs, Re^Gvs, Re^Gvs, Rr^Vhc, Rr, Rr, Rr, Gs^Fms, Gg, Rrc, Rrc, Co, Gg^Emf, Co, Re^Gvs, Gs, Re^Gvs, Rrc, Rr, Ds, Ww, Wo, Ww^Ewl, Ss^Vhs, Chs, Khs, Chs
Hh, Hh, Hh, Gg, Hh, Hh, Gg, Gg, Hh, Gs^Fms, Gg, Re^Gvs, Re^Gvs, Re^Gvs, Gg, Rp, Rp, Rr, Hh^Fms, Hh^Fms, Rrc, Rp^Edt, Rp^Em, Co, Rp, Rp, Gg^Es, Gs, Rrc, Rr, Wwr, Ww, Wo, Ss^Em, Ss^Bsb/, Chs, Ss^Bsb\, Sm
Hh, Hh, Hh, Gg, Hh, Hh, Gg, Gg, Hh, Gs^Fms, Rr^Vhc, Gg, Gs, Gg, Hh, Gg^Es, Gg, Rr, Hh, Hh, Rrc, Rp^Es, Rp^Edt, 6 Ko, Co, Co, Hh, Hh, Rr, Rrc, Sm, Ww, Wot^Bsb/, Wo^Bsb/, Wo, Sm, Wo, Wo^Bsb\
Hh, Hh, Hh, Rr^Vhc, Re^Gvs, Re^Gvs, Re^Gvs, Gg, Hh, Hh, Gg^Es, Gg, Gs, Hh, Hh^Es, Hh, Hh, Rr, Rr, Rp, Rr, Rp, Rp, Rp^Edt, Co, Hh, Hh, Hh^Fms, Gs^Fms, Rrc, Rrc, Ww^Bsb/, Sm, Ww, Sm, Wo, Ww, Ww^Ewf
Gg, Gg, Gg, Re^Gvs, Re^Gvs, Re^Gvs, Re^Gvs, Re^Gvs, Rr, Hh, Rr, Rr^Vhc, Rr, Hh, Hh^Fms, Hh^Fms, Gs^Fms, Gg, Rrc, Rp, Rr, Gs, Gs^Wm, Rp, Gs, Gg, Gs, Gs^Fms, Hh, Rr, Rr, Rr, Gs^Fms, Wwr, Hh^Fms, Sm, Gs^Fms, Ww^Em
Gg, Gs^Fds, Gs^Fds, Gg, Gs^Fds, Re^Gvs, Rr, Rr, Gg, Rr, Gg, Rr, Gg, Rr, Rr, Rr, Rr, Rr, Rrc, Rr, Rr, Re^Gvs, Re^Gvs, Re^Gvs, Re^Gvs, Gg^Es, Gg, Gg, Rrc, Rr, Gg, Gg^Es, Re^Gvs, Gs^Fms, Gg^Es, Hh, Gs, Rb
Gg, Gg, Gs^Fds, Gs^Fds, Rr, Rr, Hh, Gg, Hh, Hh, Cer, Gs^Fms, Cer^Edb, Cer, Cer^Edb, Gg, Cer^Edb, Gg^Es, Rr, Rrc, Gs, Re^Gvs, Re^Gvs, Re^Gvs, Re^Gvs, Re^Gvs, Rr^Vhc, Rp, Rrc, Gs, Re^Gvs, Re^Gvs, Re^Es, Re^Gvs, Re^Gvs, Rr^Vhc, Gg, Rb
Cer^Edb, Cer^Edb, 5 Kh, Gs^Fds, Ch, Gg, Gg, Gg, Gg, Cer^Edb, Rrc, Cer^Edb, Gg, Gg, Gs^Fds, Gg, Gg, Cer^Edb, Ch, Rrc, Gg, Gs^Edb, Gg^Fms, Re^Gvs, Re^Gvs, Re^Gvs, Gg^Fms, Rr, Rrc, Gg^Es, Gg, Re^Gvs, Re^Gvs, Re^Gvs, Re^Gvs, Re^Gvs, Gs, Gs
Gs, Gs, Gs, Ch, Rrc, Ch, Gs, Gs, Gs, Gg, Rr^Vhc, Rr, Gs, Gs^Fds, Gs, Gg^Es, Gg^Es, 4 Kh, Rrc, Ch, Gg, Cer, Cer^Edb, Hh, Hh^Fms, Hh^Fms, Rp, Gs, Rrc, Hh, Hh, Gs, Gs, Re^Gvs, Ch, Gg^Wm, Gg, Gs^Fds
Gg, Gg, Gg, Rr^Vhc, Rr, Gs^Fds, Gs^Fds, Gs^Fds, Gg, Gs^Es, Rr, Rr, Gs^Ecf, Gs^Es, Gs, Rr^Vhc, Gs, Rrc, Gs^Es, Gg, Gs, Gg, Gg, Cer, Rp, Rp, Gs, Rrc, Gs^Es, Rrc, Rr, Rrc, Rr, Gg, Ch, Gg^Es, Co, Gs^Fms
Gg, Gg, Gs^Fds, Gg, Rr, Rrc, Gg^Fet, Gs^Fds, Rrc, Gs, Rp, Gs, Gs^Fds, Gg^Fet, Gd, Gs^Es, Rrc, Rrc, Rp^Es, Rr^Vhc, Gs^Es, Gs, Gg, Cer^Edb, Gg, Gg, Ch, Rrc, Ch, Rr, Gs, Rr, Gs, Rr, 7 Kh, Gg, Gg, Gg
Gd, Gd, Gd, Gd, Rrc, Rrc, Rrc, Rrc, Rr, Rrc, Rrc, Gd^Em, Rp, Rr^Vhc, Rp, Gg^Fet, Rrc, Rp, Gd^Em, Rp, Gd, Gd, Rrc, Rrc, Rrc, Ch, Gg^Em, Ch, Gg, Cer^Edb, Cer, Gg, Gg, Ch, Rr, Co, Co, Gg^Es
Rp, Rp, Ch, Ch, Ch, Gg, Gs, Rr, Rp, Rr, Rp, Rrc, Rp, Rp, Ch, Rp, Rp, Gd^Es, Gd, Gs^Ecf, Rrc, Rrc, Gg^Fet, Gd, Gd^Es, Gd, Gs, Gs, Gd, Gg, Gg, Gg^Es, Gg, Rr, Gs, Gs^Es, Gs, Gg
Ch, Ch, Cvr, Co, Chr, Kh, Co, Gg, Co, Rp, Ko, Ch, Ch, Kh, Chr, Ch, Ch, Rp, Gd^Es, Rd, Rr, Gs^Fds, Rr^Vhc, Gs^Fds, Rp, Rp, Rr^Vhc, Gs^Fds, Gg^Fet, Gd^Es, Gg, Cer, Cer^Edb, Rr, Gg^Es, Gg, Rr, Rr
Cf, Cf, Chr, Chr, Cf, Cf, Cf, Co, Ce, Co, Cvr, Chr, Chr, Chr, Kf, Cvr, Cf, Rr^Pr\o, Rr^Pr\o, Rr, Rp, Gs, Gs^Es, Rp, Rp, Gs, Rp, Rp, Gs^Fds, Gs^Fds, Gs, Ker^Edb, Rr, Rr, Gg, Rr, Gs^Fms, Gs^Fms
Cf^Es, Cvr, Cvr, Chr, Cf, Cf^Efs, Cf, Cvr, Cvr, Chr, Cvr, Cf, Kf, Cf^Ebn, Cf, Cf^Es, Chr, Cf, Chr, Ch, Kh, Rp, Rp, Rp, Rp, Gs^Es, Gs^Ecf, Rp, Rp, Rr^Vhc, Gg^Es, Gg, Rrc, Rr, Cer^Edb, Gs^Fms, Hh^Fms, Hh^Fms
Cf^Es, Cf^Es, Cf, Chr, Cf^Efs, Cf, Cf, Kfr, Cvr, Chr, Kf, Cf^Ebn, Cf, Cf, Chr, Chr, Chr, Cvr, Kf, Cf, Ch, Rp, Gs^Es, Gg^Fet, Rp, Gs^Es, Gd, Rp, Gd^Es, Gd, Rrc, Rrc, Rr, Rrc, Ch, Gs, Hh, Gs^Fms
Cf, Cf, Cf, Chr, Chr, Chr, Chr, Chr, Chr, Chr, Cf, Cf, Cvr, Cf, Cf, Cvr, Chr, Cf^Ebn, Cf, Cvr, Cf, Ch, Rp, Gs^Em, Rrc, Rp, Rrc, Rr^Vhc, Rrc, Rrc, Gs^Fds, Gs^Fds, Gg^Es, Rrc, Ch, Rrc, Gg, Gs
Cf, Cf, Co, Cf, Cvr, Cf, Cf^Efs, Chr, Cf, Cf, 8 Kud, Cf, Cvr, Cf^Es, Kf, Cf^Ebn, Cvr, Cf, Chr, Chr, Cf, Ko, Co, Rp, Gd^Es, Rrc, Rp, Rrc, Gd, Rrc, Gg^Em, Gg^Fet, Gg, Rrc, Ch, Ch, Gs, Gg^Es
Ias, Ias, Rd, Ko, Co, Cvr, Cvr, Chr, Cvr, Cf, Cf, Cf^Es, Cvr, Cf, Cf, Cf, Cf, Chr, Cvr, Cf^Es, Cf, Cf, Co, Rp, Gd, Gd, Gd, Ias, Gg, Gg, Gg, Gg, Gg, Gg, Gg, Gg, Gg, Gs
