Gll^Fmf, Gll^Fmf, Gll^Fmf, Gll^Fmf, Gll^Fdf, Gll^Fdf, Gll^Fmf, Gll^Fmf, Gll^Fdf, Gll^Fdf, Gll^Fdf, Gll^Fdf, Gll^Fdf, Gll^Fdf, Gll^Fdf, Gll^Fdf, Gll^Fmf, Gll^Fmf, Gll^Fmw, Gll^Fmw, Gll^Fmf, Gll^Fmf, Gll^Fmf, Gs, Gll^Fdf, Gg, Gg, Gg, Gll^Fdf, Gll^Fdf, Gll^Fdf, Gll^Fdf, Gll^Fdf, Gll^Fdf, Gll^Fmf, Gll^Fmf, Gll^Fmf, Gll^Fmf, Gll^Fmf, Gll^Fmf, Gll^Fmw, Gll^Fmw, Gll^Fdf, Gll^Fdf, Gll^Fdf, Gll^Fdf, Gll^Fdf, Gll^Fdf, Gll^Fdf, Gll^Fdf, Gll^Fmw, Gll^Fmw
Gll^Fmf, Gll^Fmf, Gll^Fdf, Gll^Fdf, Gll^Fdf, Gll^Fmf, Gll^Fdf, Gll^Fdf, Gll^Fdf, Gll^Fdf, Gll^Fdf, Gll^Fdf, Gll^Fdf, Gll^Fdf, Gll^Fdf, Gll^Fdf, Gll^Fmw, Gll^Fmw, Gll^Fdf, Gll^Fmf, Gll^Fdf, Gll^Fmf, Gll^Fdf, Gs, Gg, Gg, Gg, Gg, Gll^Fdf, Gll^Fdf, Gll^Fmw, Gll^Fdf, Gll^Fmw, Gll^Fdf, Gll^Fmw, Gll^Fmf, Gll^Fmf, Gll^Fmf, Gll^Fmw, Gll^Fmw, Gll^Fmw, Gll^Fdf, Gll^Fmw, Gll^Fdf, Gll^Fmw, Gll^Fdf, Gll^Fdf, Gll^Fdf, Gll^Fdf, Gll^Fmw, Gll^Fmw, Gll^Fmw
Gll^Fmf, Gll^Fmf, Gll^Fdf, Gll^Fdf, Gll^Fmw, Gll^Fdf, Gll^Fdf, Gll^Fdf, Gll^Fmf, Gll^Fdf, Gll^Fmf, Gll^Fdf, Gll^Fdf, Gll^Fdf, Gll^Fmw, Gll^Fmw, Gll^Fmf, Gll^Fdf, Gll^Fmf, Gll^Fmf, Gll^Fmw, Gll^Fmf, Gll^Fmf, Gg, Gg^Fet, Ce, Ce, Gll^Fmw, Gll^Fmw, Ce, Gll^Fmw, Gll^Fmw, Gll^Fmw, Gll^Fmw, Gll^Fmf, Gll^Fmf, Gll^Fmw, Gll^Fmw, Gll^Fmw, Gll^Fmw, Gll^Fmw, Gll^Fmw, Gll^Fmw, Gll^Fmw, Gll^Fdf, Gll^Fdf, Gll^Fmf, Gll^Fmf, Gll^Fmf, Gll^Fmw, Gll^Fdf, Gll^Fdf
Gll^Fmf, Gll^Fmf, Gll^Fmw, Gll^Fmw, Gll^Fmw, Gll^Fdf, Gll^Fmf, Gll^Fmf, Gll^Fmf, Gll^Fmf, Gd, Gll^Fmf, Gd, Gll^Fmw, Gd, Gll^Fdf, Gs, Gll^Fmf, Gll, Gll, Gll, Gll, Gll, Gll, Gs, Gg, Ce, Gll^Fmw, 1 Ke, Ce, Gll^Fmf, Gll^Fmw, Gll^Fdf, Gll^Fmf, Gll^Fmw, Gll^Fmw, Gll^Fmf, Gll^Fmf, Gll^Fdf, Gll^Fmw, Gll^Fdf, Gll^Fmw, Gll^Fmf, Gll^Fdf, Gll^Fmf, Gll^Fmf, Gll^Fmf, Gll^Fmf, Gll^Fmw, Gll^Fmf, Gll^Fdf, Gll^Fdf
Gll^Fmf, Gll^Fmf, Gll^Fmw, Gll^Fmw, Gll^Fmw, Gll^Fmf, Gll, Gll^Fmf, Gll, Gll, Gs, Gd, Gll^Fdf, Gd, Gd, Gd, Gd, Gs, Gs, Gll^Fmw, Gll^Fdf, Gll^Fdf, Gg, Gll^Dr, Gs^Vc, Gg, Gll^Fdf, Ce, Ce, Gll^Fdf, Gll^Fdf, Gll^Fdf, Gs, Gll^Fmw, Gll^Fdf, Gll^Fdf, Gll^Fdf, Gll^Fmf, Gll^Fmf, Gll^Fdf, Gll^Fdf, Gd, Gd, Gd, Rd, Gll, Gll, Gll^Fmw, Gd, Gll^Fmw, Gll^Fdf, Gll^Fdf
Gll^Fdf, Gll^Fdf, Gll^Fmw, Gll^Fmw, Gs, Gs^Vc, Gd, Gd, Gd, Gs, Gll, Gll^Fmw, Gll^Fmw, Gll^Fdf, Gll^Fmf, Gd, Gs, Gs, Gll^Fdf, Gll^Fdf, Gll^Fdf, Gll^Fdf, Gg, Gg, Rp, Gs, Gll^Fmw, Gll^Fmw, Gll^Fdf, Gll^Fmw, Gll^Fmw, Gs, Gs, Gs, Rp, Gll^Fdf, Gll^Fmf, Gll^Fmf, Gll^Fmf, Gll^Fdf, Gll^Fmw, Gll^Fmw, Gll^Fmw, Gd, Gs, Gs^Vc, Rd, Gd, Gll^Fdf, Gll^Fdf, Gll^Fdf, Gll^Fdf
Gll^Fdf, Gll^Fdf, Gll^Fdf, Gll^Fdf, Gll^Fdf, Gs, Gll^Fmw, Gll^Fdf, Gll^Fdf, Gll, Gd, Gll^Fdf, Gll^Fdf, Gll^Fmw, Gs, Gd, Gd, Gs, Gll^Fdf, Gll^Fdf, Gll^Fdf, Gll^Fdf, Gg, Gll^Fdf, Rp, Gs, Rp, Gll^Fdf, Gll^Fdf, Gll^Fdf, Gs, Rp, Rp, Rp, Gll^Fmw, Gll^Fmf, Gll^Fmf, Gll^Fmf, Gll^Fmf, Gll^Fmf, Gll^Fmf, Gll^Fmw, Gll^Fmw, Gll^Fmw, Gll^Fmf, Gd, Gll, Gll^Fdf, Gll^Fdf, Gll^Fdf, Gll^Fmw, Gll^Fmw
Gll^Fdf, Gll^Fdf, Gll^Fdf, Gll^Fmf, Sm, Gll^Fmw, Gll^Fdf, Gll^Fdf, Wwf, Wwf, Gll^Fmf, Gll^Fdf, Gll^Fdf, Gll^Fdf, Gs, Gs, Gs, Gd, Gll^Fdf, Gll^Fdf, Gll^Fmf, Gll^Fdf, Gll^Fmw, Gg, Rp, Rp, Gg, Gll, Gll^Fdf, Gll^Fdf, Gll^Fmw, Rp, Rd, Gll, Gll, Gll^Fdf, Gll^Fmw, Gll^Fmf, Gll^Fmf, Gll^Fdf, Gll^Fdf, Gll^Fmw, Gs, Gll^Fdf, Gll, Gd, Gd, Gll, Gll, Gll^Fmw, Gll^Fmw, Gll^Fmw
Gll^Fmw, Gll^Fmw, Gll^Fdf, Gll^Fmf, Wwf, Wwf, Ss, Gll^Fdf, Ww, Wwf, Gll^Fdf, Gll^Fmf, Gll^Fmw, Gll^Fmw, Gll^Fmw, Rp, Rp, Gll^Fdf, Gll, Gll, Rd, Gll^Fmw, Gg, Gs, Gs, Gs, Gll, Gll^Fdf, Gll, Gll^Fmw, Gll^Fmw, Gll^Fmw, Gll^Fdf, Rd, Rd, Rd, Rd, Gll^Fdf, Rd, Gll^Fdf, Gll, Gs, Gs, Gll, Rd, Gs, Gll, Gs, Gll^Fmw, Gll^Fmw, Gll^Fmf, Gll^Fdf
Gll^Fdf, Gll^Fdf, Wwf, Wwf, Sm, Wwf, Ss, Ss, Ww, Ww, Wwf, Gll^Fmw, Gll^Fdf, Gll^Fmw, Gll, Gll, Rp, Gll, Rd, Rd, Gd, Gll^Fdf, Gg, Gs, Gs, Gs, Gll^Fdf, Gll^Fdf, Gll^Fdf, Gll, Gll, Gll^Fdf, Gll^Fdf, Gll^Fdf, Gll^Fmf, Gll^Fdf, Gll^Fmw, Rd, Gd, Rd, Gd, Rd, Gll, Rd, Gll^Fmf, Gs, Gll^Fmw, Gll^Fmw, Gll^Fmw, Gll^Fmw, Gll^Fdf, Gll^Fmf
Ww, Ww, Ss, Sm, Ss, Ss, Ss, Ww, Ww, Ww, Wwf, Wwf, Gll^Fdf, Gll^Fmw, Rd, Rd, Rd, Rp, Gd, Gd, Gs, Gs, Gs, Gs, Rp, Gll, Gll^Fmf, Gll^Fdf, Gll, Gll, Gll, Gll, Gll, Gll^Fdf, Gll^Fmw, Gll^Fmw, Gll^Fmw, Gll^Fmw, Gll^Fdf, Gll, Gll, Gll, Gll^Fdf, Gll^Fdf, Gll^Fdf, Gll^Fmf, Gll^Fmw, Gll^Fmw, Gll^Fdf, Gll^Fdf, Gll^Fmw, Gll^Fmw
Ss, Ss, Wo, Wo, Wo, Ww^Ewf, Wo, Wo, Ww, Ww, Ww, Ww, Rd, Gll^Fdf, Rp, Rp, Gs, Gd, Gs, Gs, Rp, Rp, Rp, Rp, Rp, Rp, Rp, Rp, Rp, Rp, Gs^Vc, Gll, Gll, Gll, Gll^Fmw, Gll^Fmw, Gll^Fdf, Gll^Fdf, Gll^Fdf, Gll^Fdf, Gs, Gll^Fdf, Gll^Fdf, Gll^Fdf, Gll^Fdf, Gll^Fmf, Gll^Fmf, Gll^Fdf, Gll^Fdf, Gll^Fdf, Gll^Fmw, Gll^Fmw
Ss, Wo, Wo, Wo, Wo, Wo, Wo, Wo, Ww, Ww, Gll, Gll, Rd, Rp, Gs^Vc, Gs^Dr, Gd, Gd, Gd, Rp, Rp, Gs, Gd, Rd, Gd, Gd, Gll^Fmw, Gll^Fdf, Gd, Gd, Rp, Gll, Gll^Fmw, Gll^Fmw, Gll^Fmf, Gll^Fdf, Gll^Fdf, Gll^Fdf, Gll^Fdf, Gd, Gd, Gll^Fmw, Gll^Fmw, Gll^Fdf, Gll^Fdf, Gll^Fmf, Gll^Fmf, Gll^Fmf, Gll^Fmw, Gll^Fdf, Gll^Fdf, Gll^Fdf
Ss, Wo, Wo, Wo, Rb, Sm, Sm, Wo, Ww^Bw/r, Ww^Bw/r, Rd, Gll^Fdf, Gd, Gd, Gd, Gd, Gd, Gd, Rp, Rp, Rd, Gll^Fdf, Rd, Gd, Gll^Fmw, Gd, Gll, Gll^Fmf, Gll^Fdf, Gs, Gs, Rp, Rp, Gll^Fmw, Gll^Fmf, Gll^Fdf, Rd, Rd, Rd, Gs, Gd, Gll^Fmw, Gll^Fdf, Gll^Fdf, Gll^Fdf, Gll^Fdf, Gll^Fmw, Gll^Fmw, Gll^Fmw, Gll^Fmw, Gll^Fdf, Gll^Fdf
Wo, Wo, Wo, Wo, Rb, Rb, Sm^Bw/r, Sm^Bw/r, Ww, Wo, Gll, Gll, Gd, Gd, Gs, Gs, Gd, Gll, Hhd, Rd, Hhd^Vhhr, Gll^Fdf, Rd, Rd, Gll, Gll, Gll^Fdf, Gll^Fdf, Gll^Fmw, Gll^Fmw, Gs, Gll, Gll, Gll^Fmw, Rd, Gs, Gll^Fdf, Gs, Gll^Fdf, Rd, Gs, Gll, Gll^Fmw, Gll^Fdf, Gll^Fdf, Gll^Fdf, Gll^Fmw, Gll^Fmw, Gll^Fmw, Gll^Fdf, Gll^Fdf, Gll^Fdf
Wo, Wo, Wo, Sm, Rb, Rb, Ss, Sm, Ww, Wo, Ww, Gs, Rp, Rp, Gd, Gd, Hhd, Gll, Hhd, Hhd, Mm, Gll^Fdf, Gll^Fdf, Gll^Fdf, Gll^Fdf, Gll^Fdf, Gll^Fmw, Gll^Fmw, Gll^Fdf, Gs, Gll, Gs, Rp, Gll^Fmw, Rd, Gs, Gll^Fmf, Gll^Fdf, Gll^Fdf, Gll^Fdf, Rd, Gll, Gll^Fmw, Gll^Fmw, Gll^Fdf, Gll^Fmf, Wwr, Gll^Fmw, Gll^Fdf, Gll^Fdf, Ww^Ewf, Ww
Wo, Wo, Wo, Rb, Rb, Rb, Ss^Vhs, Ss, Ww, Ww, Ww, Gd, Rp, Rp, Hhd, Hhd, Hhd^Vhhr, Hhd, Mm, Mm^Xm, Mm, Mm, Gll^Fmf, Gll^Fdf, Gll, Gll^Fmw, Gll^Fdf, Gll^Fdf, Gll^Fdf, Gll^Fdf, Gll^Fdf, Gll, Gll, Rd, Gll^Fmf, Gll^Fdf, Gll^Fdf, Gll^Fmf, Gll^Fmf, Gll^Fdf, Gll, Rd, Gll^Fmw, Gll^Fmw, Gll^Fdf, Gll^Fmf, Wwf, Ww^Ewf, Ww, Gll^Fdf, Ww, Ww
Wo, Wo, Wo, Ww, Wwf^Bw|r, Ss, Wo, Wo, Wo, Ww, Ww, Ww, Gll^Dr, Rd, Rd, Hhd, Hhd, Hhd, Hhd, Mm, Mm^Xm, Mm, Gs, Gll, Gs, Gd, Gll, Gll^Fdf, Gll^Fdf, Gll^Fdf, Gll, Gll, Gd, Gll^Fmf, Gll^Fmf, Gll^Fdf, Gll^Fdf, Gll^Fdf, Gll^Fdf, Gll^Fdf, Gs^Vc, Gs, Gll^Fdf, Gll^Fdf, Ww, Wwf, Wwr, Wwf, Ww, Ww, Ww, Ww
Wo, Wo, Wo, Wo, Wo^Bw|r, Wo, Wo, Wo, Wo, Ww, Ww, Wwf, Gll, Gll, Gll, Rd, Rd, Hhd, Mm, Mm, Mm, Mm, Wwf, Wwf, Ww, Ww, Ww, Gll, Gs, Gll^Fdf, Gd, Gd, Gll^Fdf, Gll^Fdf, Gll^Fdw, Gll^Fmf, Gll^Fdf, Wwr, Wwr, Wwr, Gll^Fmw, Rd, Ww, Ww, Ww, Wwr, Gll^Fdf, Gll^Fdf, Ww, Ww, Ww, Ww
Wo, Wo, Wo, Wo, Wo^Bw|r, Wo, Wo, Wo, Ww, Ww, Ww, Gd, Rd, Gs^Vc, Gd, Gd, Gll, Hhd, Hhd, Hhd, Hhd, Hhd, Gll^Fmw, Gll^Fdf, Gll^Fdw, Wwr, Gll^Fdf, Ww, Wwr, Gs, Gd, Gd, Gll, Gll^Fdf, Gll^Fdw, Gll^Fdf, Gll^Fmf, Gll^Fmw, Wwr, Ww^Ewf, Wwf, Gll, Ww^Bw\r, Ww, Ww, Wwr, Ww, Ww^Ewf, Wo, Wo, Wo, Wo
Sm, Ss, Ss, Ss, Rb, Ss, Ss, Ss, Wwf, Ww, Gll, Rd, Gd, Gd, Gd, Gd, Gd, Gll, Gd, Gll^Fdf, Gd, Hhd, Gll^Fdf, Gll^Fdf, Gll^Fdf, Gll^Fdw, Gll^Fdw, Ww, Ww, Ww, Ww, Gll, Gd, Gll, Gll, Gll^Fdw, Gs^Vc, Gll^Fmf, Wwf, Wwf, Wwf, Wwf, Ww, Ww^Bw\r, Ww^Bw\r, Wo, Wo, Wo, Wo, Wo, Wo, Wo
Sm, Sm, Sm, Rb, Wwf, Ss, Ss^Vhs, Ss, Ss, Wwf, Gd, Gd, Gll^Fdf, Gll^Fmf, Gll, Gll, Rp, Gd, Gll, Gd, Gll, Re, Re, Re, Re, Gll^Fmf, Gll^Fmf, Gll^Fdf, Gll^Fdf, Wo, Wo, Ww, Wwf, Wo, Wwr, Gll, Gs, Gd, Wwf, Wwf, Ww, Ww, Wo, Wo, Wo, Ww^Bw\r, Rb, Sm, Sm, Wo, Wo, Wo
Sm, Ss, Ss, Rb, Rb, Wwf, Ss, Ss, Ss, Wwf, Rd, Gll^Fdw, Gll^Fdf, Gll^Fdw, Gll, Gll, Gll, Re, Re, Gll, Rd, Gll, Gd, Gd, Gd, Re, Gd, Gll^Fmf, Gll^Fdf, Gll^Fmw, Gd, Wo, Gd, Ww, Gll^Fmw, Wwf, Gll^Fmw, Wwf, Wo, Ww, Wo, Wo, Wo, Wo, Wo, Wwf, Rb, Rb, Sm^Em, Sm, Wo, Wo
Sm, Sm, Ss, Rb, Wwf, Wwf, Ss, Sm, Sm, Sm, Rd, Gll^Fdw, Gll^Fdw, Gll^Fdw, Gs, Gll, Gll, Rp, Rp, Re, Re, Gd, Rd, Rd, Rd, Rd, Rd, Gd, Rd, Gll^Feth, Gd, Gd, Gll, Gll^Fdf, Gll^Fmw, Gll^Fmw, Gll^Fdf, Gll^Fdf, Ww, Wo, Wo, Wo, Wo, Wo, Wo, Sm, Rb, Rb, Ss^Em, Sm, Wo, Wo
Ss, Sm, Ss, Rb, Rb, Sm, Sm, Sm, Ss, Sm, Rd^Em, Rd, Rd, Gll^Fdw, Gll^Fdw, Gs, Gs, Gll, Rd, Rp, Rd, Re, Re, Re, Gll, Gll, Gll, Re, Re, Rd, Gll, Gll^Fdw, Gll^Fdw, Gll, Gll, Gll^Fdf, Gll^Fdf, Gll^Fdf, Ww, Ww, Wo, Wo, Wo, Wo, Wo, Rb, Rb, Rb, Ss^Vhs, Ss, Ww, Wo
Ss, Ss, Ss, Rb, Rd^Edb, Gll, Gll, Gll^Fdw, Ss, Ss, Gll^Fdw, Rd, Rd, Rd, Gll^Fmf, Gll^Fdw, Gll^Fdw, Gs, Hhd, Rd, Rd, Gll^Fmw, Gll^Fdf, Gll, Gll, Re^Vct, Rp, Gll, Gd, Re, Re, Gll, Gll^Fdw, Gll^Fdw, Gll^Fdw, Gll^Fdf, Gll^Fdf, Gll^Fdf, Wwr, Ww, Wo, Wo, Wo, Wo, Wo^Bw/r, Wo^Bw/r, Wwf, Ss, Wo, Wo, Wo, Wo
Gll^Fdw, Gll^Fdw, Ss, Ss, Ss, Rd^Edb, Rd, Gll, Gll, Ur, Ur, Ur, Uhe, Gll, Hhd, Gll^Fdf, Hhd, Hhd^Vhhr, Gll^Fdw, Gll^Fdw, Gll^Fdf, Gll^Fdf, Gll^Fdf, Gll, Gll, Gll^Edb, Gd, Gd, Gll^Fdf, Gll^Fdw, Gll, Rb, Re, Gll^Fdw, Gll^Fdf, Gll^Fdw, Gll^Fdw, Gll^Fmf, Wwr, Ww, Wo, Wo, Wo^Bw/r, Wo^Bw/r, Wo, Wo, Wo, Wo, Wo, Wo, Wo, Wo
Gll^Fdw, Gll^Fdw, Ss, Chs, Chs, Sm, Gll^Fdw, Gll, Gll^Fdw, Ur, Uhe, Uhe, Ur, Ur, Ur, Hhd, Uhe, Uhe, Gll^Fdw, Gll^Fdw, Gll^Fdw, Gll^Fdf, Gll^Fdf, Gll^Fdf, Gll^Fdw, Gll, Gd, Gd, Gd, Gll^Fdw, Rb, Rb, Gll, Gll, Gll, Gll, Rb, Wwf, Wwf, Wwf, Ss^Bw/r, Wo^Bw/r, Wwf, Wo, Wo, Wo, Wo, Wo, Wo, Wo, Wo, Wo
Gll^Fdw, Gll^Fdw, Ss, 3 Khs, Sm, Sm, Ur^Edb, Gll^Fdw, Uhe, Uhe, Ur, Ur, Uhe^Edb, Ur, Gll^Fdw, Ur, Ur^Edb, Uhe, Uhe, Gll^Fdw, Gll^Fdw, Gll^Fdw, Gll^Fdw, Gll^Fdw, Gll^Fdw, Gd, Gd, Gd, Rp, Rb, Rb, Rb, Rd, Rb^Edb, Rb, Gll, Rb, Rb, Rb, Rb, Gll^Fdw, Ss, Sm, Ss, Ss, Ss, Ss, Ss, Ss, Ss, Ss, Ss
Gll^Fdw, Gll^Fdw, Gll^Fdw, Sm, Ur^Edb, Ur^Edb, Sm, Uhe, Uu^Vu, Uhe, Sm, Ur, Uhe^Edb, Gll^Fdw, Rb, Ur^Edb, Ur^Edb, Ur, Gll^Fdw, Gll^Fdw, Gll^Fmf, Gll^Fdw, Gll^Fdw, Gll^Fdw, Gll^Fdw, Gll^Fdf, Gll^Fdf, Rb, Gll, Re, Rb, Rd^Ecf, Rb, Re^Vct, Rb, Rb, Gll^Fdw, Gll^Fdf, Gll^Fmf, Gll^Fmf, Gll^Fdw, Gll^Fdw, Gll^Fdw, Sm, Sm, Ss, Sm, Ss, Ss^Vhs, Ss, Ss, Ss
Ur^Edb, Ur^Edb, Ur^Edb, Sm, Ur^Edb, Ur^Edb, Ur^Edb, Uu^Edb, Ur^Edb, Ur^Edb, Rb^Edb, Sm, Rb^Edb, Uhe^Edb, Gll^Feth, Gll^Fdw, Gll^Fdw, Ur, Rb^Edb, Rb^Edb, Rb^Edb, Rb^Edb, Rb^Edb, Gll^Fdf, Gll, Gll^Fdw, Rb, Re, Re, Re, Gll, Rb, Gll^Fdf, Rb, Gll^Fdw, Rb, Rb, Gll^Fdw, Gll^Fdw, Gll^Fdw, Gll^Fdw, Gll^Fdw, Gll^Fdw, Gll^Fdw, Sm, Sm, Sm, Sm, Sm, Ss, Ss, Ss
Gll^Fdw, Ur^Edb, Ur^Edb, Ur^Edb, Gll^Fdw, Rb^Edb, Rb^Edb, Uu^Edb, Rb^Edb, Rb^Edb, Rb^Edb, Sm, Rb^Edb, Gll, Gll, Gll, Rd, Gll, Rd, Rd^Ecf, Rd, Rb^Edb, Rd, Rd, Rb, Rb, Re, Rb, Gll^Fdw, Rb, Gll^Fmf, Gd^Fetd, Gll^Fdf, Gll^Fdf, Gll^Fdf, Gll^Fdw, Rb, Rb, Gll, Gll^Fdw, Rb, Gll^Fdw, Gll, Gll^Fdw, Gll^Fdw, Gll^Fdf, Gll^Fdf, Sm, Sm, Sm, Sm, Sm
Gll^Fdw, Ur^Edb, Gll^Fdw, Gll^Fdw, Rb^Edb, Rb^Edb, Rb^Edb, Rb^Edb, Ias, Ias, Ias, Rb^Edb, Rb^Edb, Rb^Edb, Rb^Edb, Rd, Rb^Edb, Gll, Rb^Edb, Rb^Edb, Rb^Edb, Rb^Edb, Sm, Sm, Ss, Gll, Gll^Fdw, Gll^Fdw, Gll^Fdf, Gll^Fdw, Gll^Fdw, Gll^Fdf, Gll^Fdw, Gll^Fdf, Gll^Fdw, Gll^Fdw, Rb, Gll, Gll, Rb, Gll^Fdf, Gll, Rb, Gll, Gll, Gll^Fdw, Gll^Fdw, Gll^Fdw, Sm, Sm, Sm, Sm
Gll^Fdw, Ur^Edb, Ur^Edb, Ur^Edb, Uhe^Edb, Uhe^Edb, Rb^Edb, Ias, Ias, Ias, Gd, Ias, Ias, Ias, Rb^Edb, Rb^Edb, Rb^Edb, Rb^Edb, Uhe, Uhe^Edb, Uhe, Sm, Ss^Vhs, Ss, Ss, Ss, Ur, Ur, Ur, Gll^Fdf, Gll^Fdw, Gll^Fdw, Gll^Fdw, Gll^Fdw, Gll^Fdf, Gll, Gll^Fdf, Gll, Gll^Fdf, Gll^Fdf, Gll^Fdf, Gll^Fdf, Gll^Fdf, Gll^Fdw, Gll^Fdw, Gll, Rb, Gll^Fdf, Gll^Fdf, Sm, Sm, Sm
Gll^Fdw, Gll^Fdw, Rb^Edb, Rb^Edb, Uu, Uhe^Edb, Uhe^Edb, Ias, Ias, Gd^Fetd, Gd, Gd, Gd, Ias, Rb^Edb, Rb^Edb, Uhe, Ur^Edb, Ur^Edb, Ur^Edb, Ur^Edb, Uhe, Uhe, Ss, Chs, Ss, Ur, Uu^Vu, Uu, Gll^Fdw, Gll^Fdw, Gll^Fdw, Gll, Gll^Fdf, Rb, Rb, Gll^Fdw, Gll^Fdf, Gll^Fdw, Gll^Fdf, Gll^Fdf, Gll^Fdf, Gll^Fdf, Gll^Fdf, Gll^Fdw, Gll^Fdw, Gll, Gll^Fdf, Gll^Fdf, Sm, Sm, Sm
Gll^Fdw, Gll^Fdw, Ur^Edb, Ur^Edb, Uu^Vu, Uu, Ss, Uhe^Edb, Uhe^Edb, Uhe^Edb, Uhe^Edb, Gd, Gll^Feth, Gll, Sm, Uhe^Edb, Ur^Edb, Ur^Edb, Ur^Edb, Ur^Edb, Uhe, Ur^Edb, Ss, Chs, Sm, Sm, Ur, Uu, Gll^Fdw, Gll^Fdw, Gll^Fdf, Gll, Gll^Fdf, Gll, Gll^Fdw, Gll^Fdw, Gll^Fdf, Gll^Fdf, Gll^Fdw, Gll^Fdw, Gll^Fdw, Gll^Feth, Gll^Fdf, Gll^Fdf, Gll^Fdw, Gll^Fdw, Gll^Fdw, Gll, Gll^Fdf, Gll^Fdf, Gll^Fdw, Sm
Gll^Fdw, Gll^Fdw, Ur^Edb, Rb^Edb, Sm, Sm, Ss, Ss, Ss, Ias^Edb, Ias^Edb, Uhe^Edb, Gll, Gll, Rb^Edb, Uhe, Uhe, Rb, Uhe, Uhe, Ur^Edb, Sm, Ss, 4 Khs, Sm, Ur, Ur, Gll^Fdw, Gll^Fdw, Gll^Fdw, Gll^Fdw, Gll^Fdf, Gll^Fdw, Rb, Gll^Fdw, Gll^Fdf, Gll^Fdf, Gll^Fdf, Gll^Fdf, Gll^Fdw, Gll^Fdw, Gll^Fdf, Gll^Fdw, Gll^Fdf, Gll^Fdw, Gll^Fdw, Gll^Fdw, Gll, Rb, Gll^Fdf, Gll^Fdw, Sm
Gll^Fdw, Gll^Fdw, Ur^Edb, Rb^Edb, Ss, Ss, Chs, Chs, Chs, Ss, Sm, Ias^Edb, Ias^Edb, Rb^Edb, Rb^Edb, Rb^Edb, Rb^Edb, Uhe, Ur^Edb, Ur^Edb, Sm, Sm, Ss, Gll^Fdw, Gll^Fdw, Ur, Gll^Fdw, Rb, Rb, Gll^Fdw, Gll^Fdw, Gll^Fdw, Gll^Fdw, Rb, Gll, Gll, Gll, Gll^Fdf, Gll^Fdf, Gll^Fdf, Rb, Gll^Fdw, Gll^Fdw, Gll^Fdw, Gll^Fdw, Gll^Fdw, Rb, Rb, Gll^Fdf, Gll^Fdf, Gll^Fdw, Sm
Gll^Fdw, Ur^Edb, Uhe^Edb, Ss, Ss, Ss, Sm, 2 Khs, Chs, Ss, Ss, Sm, Sm, Rb^Edb, Uu^Edb, Rb^Edb, Gll^Fdw, Rb^Edb, Ur^Edb, Ur^Edb, Sm, Sm, Sm, Gll^Fdw, Gll^Fdf, Gll^Fdw, Gll^Fdf, Gll^Fdw, Gll^Fdw, Rb, Gll, Gll^Fdw, Rb, Rb, Gll^Fdf, Gll^Fdw, Gll^Fdw, Rb, Gll, Gll, Gll, Gll, Gll, Gll^Fdw, Rb, Rb, Gll, Gll^Fdf, Gll^Fdf, Gll^Fdf, Gll^Fdw, Gll^Fdw
Gll^Fdw, Uhe^Edb, Uhe^Edb, Uhe^Edb, Uhe^Edb, Uhe^Edb, Uhe^Edb, Uhe^Edb, Uhe^Edb, Chs, Ss, Ss, Uhe^Edb, Uu^Vu, Uhe^Edb, Uhe^Edb, Uhe^Edb, Uhe^Edb, Sm, Sm, Sm, Sm, Gll^Fdf, Gll^Fdw, Gll^Fdf, Gll^Fdf, Gll^Fdf, Gll^Fdf, Gll^Fdf, Gll^Fdw, Gll^Fdf, Gll, Gll^Fdf, Gll^Fdw, Gll^Fdf, Gll^Fdf, Gll^Fdw, Gll^Fdw, Gll^Fdw, Gll^Fdw, Gll^Fdw, Gll^Fdw, Gll^Fdw, Gll, Gll^Fdf, Gll, Gll^Fdf, Rb, Gll, Gll^Fdw, Gll^Fdw, Gll^Fdw
Gll^Fdw, Uhe^Edb, Ur^Edb, Gll^Fdw, Gll^Fdw, Uhe^Edb, Ur^Edb, Uhe^Edb, Uhe^Edb, Ss, Uhe^Edb, Uhe^Edb, Ur^Edb, Uhe^Edb, Sm, Sm, Gll^Fdw, Sm, Gll^Fdw, Gll^Fdw, Gll^Fdf, Gll^Fdf, Gll^Fdf, Gll^Fdf, Gll^Fdf, Gll^Fdf, Gll^Fdw, Gll^Fdw, Gll^Fdw, Gll^Fdf, Gll^Fdw, Gll^Fdf, Gll^Fdf, Gll^Fdf, Gll^Fdw, Gll^Fdw, Gll^Fdw, Gll^Fdw, Gll^Fdw, Gll^Fdw, Gll^Fdw, Gll^Fdw, Gll^Fdw, Gll^Fdf, Gll^Fdf, Gll^Fdf, Gll^Fdf, Gll^Fdw, Gll^Fdw, Gll, Gll^Fdw, Gll^Fdw
Gll^Fdw, Gll^Fdw, Gll^Fdw, Ur^Edb, Gll^Fdw, Gll^Fdw, Gll^Fdw, Ur^Edb, Gll^Fdw, Gll^Fdw, Gll^Fdw, Ur^Edb, Ur, Sm, Gll^Fdw, Gll^Fdw, Gll^Fdw, Gll^Fdw, Gll^Fdw, Gll^Fdw, Gll^Fdf, Gll^Fdf, Gll^Fdf, Gll^Fdf, Gll^Fdw, Gll^Fdw, Gll^Fdw, Gll^Fdw, Gll^Fdw, Gll^Fdw, Gll^Fdf, Gll^Fdf, Gll^Fdf, Gll^Fdf, Gll^Fdw, Gll^Fdw, Gll^Fdw, Gll^Fdw, Gll^Fdw, Gll^Fdw, Gll^Fdw, Gll^Fdw, Gll^Fdw, Gll^Fdw, Gll^Fdf, Gll^Fdf, Gll^Fdf, Gll^Fdw, Gll^Fdw, Gll^Fdw, Gll^Fdw, Gll^Fdw
