Rp, Gs^Fds, Gs^Fds, Gs^Fds, Gs^Fds, Gs^Fds, Gs^Fds, Gs^Fds, Gs^Fds, Gg, Cv, Gs^Fds, Gs^Fds, Gg, Gg, Gg, Gs^Fds, Gs^Fds, Gs^Fds, Gg, Gs^Fds, Gs^Fds, Gs^Fds, Gs^Fds, Gs^Fds, Gs^Fds, Gs^Fds, Gs^Fds, Gs^Fds, Gs^Fds, Gs^Fds, Gs^Fds, Gs^Fds, Gs^Fds, Gs^Fds, Gs^Fds, Gs^Fds, Gs^Fds
Gg^Eff, Gs^Fds, Gs^Fds, Gs^Fds, Gs^Fds, Gs^Fds, Gs^Fds, Gs^Fds, Gg, Gg, Gs^Fds, Gs^Fds, Gs^Fds, Gg, Gg, Gs^Fds, Gs^Fds, Gs^Fds, Gs^Fds, Gs^Fds, Gs^Fds, Gs^Fds, Gg, Gs^Fds, Gs^Fds, Gs^Fds, Gs^Fds, Gs^Fds, Gs^Fds, Gs^Fds, Gs^Fds, Gs^Fds, Gll, Gs^Fds, Gs, Gs^Fds, Gs^Fds, Gs^Fds
Gg^Gvs, Gg^Eff, Gg^Eff, Gs^Fds, Gg, Gs^Fds, Gg, Gg, Gs, Gg, Ww, Ss, Ss, Gg, Gg, Gg^Es, Gs^Fds, Gs^Fds, Gs^Fds, Gs^Fds, Gll, Gg, Gs, Gs, Gg, Gll, Gll, Gs^Fds, Gs^Fds, Gs^Fds, Gs, Gll, Gg, Gll, Gs^Fds, Gs^Fds, Gs^Fds, Gs^Fds
Gg^Gvs, Gg^Gvs, Gg^Gvs, Gg^Eff, Gg^Eff, Gg, Rp, Gg, Gs, Gs, Ww, Wwr, Ss, Gg^Fet, Gg, Gs^Fds, Gs^Fds, Gg, Gg, Gll, Gs^Fds, Gs^Fds, Gs^Fds, Gs, Gs^Fds, Gll, Gs^Fds, Gg, Gg, Gg, Gs^Fds, Gs^Fds, Gs^Fds, Gg, Gs^Fds, Gs^Fds, Gs^Eqf, Gs^Eqf
Gg^Gvs, Gg^Gvs, Gg^Gvs, Gg^Gvs, Gg^Eff, Gg^Eff, Gg, Gs, Gg^Efm, Gg, Ss, Ss, Gs^Fds, Ss^Es, Gs^Fds, Gs^Fds, Gs^Fds, Gs^Fds, Gg, Gs^Fds, Gs^Fds, Gs^Fds, Gs^Fds, Gs^Fds, Rb, Rb, Gs^Fds, Gs^Fds, Gs^Fds, Gll, Gll, Gs^Fds, Gs^Fds, Gs^Fds, Gs^Eqf, Gs^Eqf, Gs^Fds, Gs^Fds
Gg^Eff, Gg^Gvs, Gg^Eff, Gg^Eff, Gs^Fds, Gg, Gs^Fds, Gg, Gg^Efm, Gg, Gs^Eqf, Gs^Eqf, Gg^Eqf, Gs^Fds, Gg, Gs^Fds, Cv, Gs^Fds, Gs^Fds, Gs^Fds, Gs^Fds, Gs^Fds, Gs^Fds, Gs^Fds, Gs^Fds, Gs^Fds, Gs^Eqf, Gs^Fds, Gs^Fds, Gs^Fds, Gs^Fds, Gs^Fds, Gs^Eqf, Gs^Eqf, Gs^Fds, Gs^Fds, Gs^Fds, Gs^Fds
Rp, Gg^Eff, Gs^Fds, Gs^Fds, Gs^Fds, Gs^Fds, Gs^Fds, Gg, Gg^Efm, Gg^Efm, Gg, Gg, Gs^Fds, Gs^Eqf, Gs^Eqf, Gs^Eqf, Gs^Fds, Gs^Eqf, Gs^Eqf, Rb, Gs^Fds, Gs^Fds, Gs^Fds, Gs^Fds, Gs^Eqf, Gs^Eqf, Gs^Fds, Gs^Eqf, Gs^Eqf, Gs^Fds, Gs^Eqf, Gs^Eqf, Gs^Fds, Gs^Fds, Gs^Fds, Gs^Fds, Gll, Gs^Fds
Gs, Gs^Fds, Gs^Fds, Gs^Fds, Gs^Fds, Gs^Fds, Gs^Eqf, Gs^Eqf, Gg, 1 Gg^Efm, 2 Gs^Fds, Cv, Gs^Fds, Gs^Fds, Gg, Gs^Fds, Gg, Gs^Fds, Rb, Gg^Eqf, Gs^Eqf, Gs^Fds, Gs^Eqf, Gs^Eqf, Gs^Fds, Gs^Fds, Gs^Fds, Gs^Fds, Gs^Fds, Gs^Eqf, Gs^Fds, Gs^Fds, Gs^Fds, Gs^Fds, Gs^Fds, Gs^Fds, Gs^Fds, Gll
Rp, Gs^Fds, Gg, Gs^Fds, Gs^Eqf, Gs^Eqf, Gs^Fds, Gs^Fds, Gs^Fds, Gg, Gg, Gs^Fds, Gs^Fds, Gs^Fds, Gs^Fds, Gg^Ve, Gg, Gg, Gs^Fds, Gs^Fds, Gs^Fds, Gs^Eqf, Gs^Fds, Gs^Fds, Gs^Fds, Gs^Fds, Gll, Gll, Gll, Gs^Fds, Gll, Gs^Fds, Gll, Gs^Fds, Gs^Fds, Gs^Fds, Gs^Fds, Gs^Fds
Rp, Gg, Gs^Eqf, Gs^Eqf, Gs^Fds, Gg, Gs^Fds, Gs^Fds, Gs^Fds, Gs^Fds, Gg, Gg, Gs^Fds, Gs^Fds, Gs^Fds, Gg, Gs^Fds, Gs^Fds, Gs^Fds, Gs^Fds, Gs^Fds, Gs^Fds, Gs^Fds, Gs^Fds, Gg, Gll, Gll, Gll, Gs^Fds, Gll, Gs^Fds, Gll, Gs^Fds, Gs^Fds, Gs^Fds, Gs^Fds, Gs^Fds, Gs^Fds
Gs^Eqf, Gs^Eqf, Gs^Fds, Gs^Fds, Gs^Fds, Gs^Fds, Gs^Fds, Gs^Fds, Gs^Fds, Gs^Fds, Gg^Efm, Gs^Fds, Gs^Fds, Gs^Fds, Gs^Fds, Gs^Fds, Gll, Gll, Gll, Gll, Gll, Gs^Fds, Gs^Fds, Gs^Fds, Gg, Gg^Efm, Gs^Fds, Gs^Fds, Gs^Fds, Gs^Fds, Gs^Fds, Gs^Fds, Gs^Fds, Gs^Fds, Gs^Fds, Gs^Fds, Gs^Fds, Gs^Fds
Gs^Fds, Gs^Fds, Gs^Fds, Gs^Fds, Gs^Fds, Gs^Fds, Gll, Gll, Gg, Gg^Efm, Gg, Gs^Fds, Gg, Gs^Fds, Gg, Gll, Gs^Fds, Gs^Fds, Gs^Fds, Gs^Fds, Gg^Efm, Gg^Efm, Gs^Fds, Gg, Gg^Efm, Gg^Efm, Gg^Efm, Gs^Fds, Gg, Gs^Fds, Gg, Gs^Fds, Gg, Gs^Fds, Gg, Gs^Fds, Gg, Gs^Fds
Gs^Fds, Gs^Fds, Gs^Fds, Gs^Fds, Gg, Gg, Gll, Gll, Gg^Ve, Gg^Efm, Gg, Gg, Gs^Fds, Gg, Gs^Fds, Gg, Gg, Gs^Fds, Gs^Fds, Gg, Gg, Gg^Efm, Gll, Gll, Gs^Fds, Gs^Fds, Gs^Fds, Gg, Gs^Fds, Gll, Gll, Gll, Gll, Gll, Gll, Gg, Gg, Gg
Cv, Gs^Fds, Gll, Gll, Gll, Gs^Fds, Gll, Gs^Fds, Gs^Fds, Gg, Gs^Fds, Gg, Gg, Gs^Fds, Gs^Fds, Gs^Fds, Gs^Fds, Gs^Fds, Gll, Gs^Fds, Gll, Gll, Gll, Gs^Fds, Gs^Fds, Gs^Fds, Gs^Fds, Gs^Fds, Gs^Fds, Gs^Fds, Gs^Fds, Gs^Fds, Gs^Fds, Gll, Gll, Gs^Fds, Gs^Fds, Gs^Fds
Ww, Gg^Efm, Gg^Efm, Gs^Fds, Gs^Fds, Gs^Fds, Gs^Fds, Gll, Gg^Ve, Gs^Fds, Gs^Fds, Gll, Rb, Gll, Gs^Fds, Gg, Gg, Gs^Fds, Gg, Gll, Gll, Gs^Fds, Gs^Fds, Gs^Fds, Gs^Fds, Gs^Fds, Gs^Fds, Gs^Fds, Gs^Fds, Gs^Fds, Gll, Gs^Fds, Gs^Fds, Gll, Gs^Fds, Gs^Fds, Gs^Fds, Gs^Fds
Wo, Ww, Wo, Cv, Gll, Gll, Gs^Fds, Gs^Fds, Gs^Fds, Gs^Fds, Gs^Fds, Gs^Fds, Gs^Fds, Gg, Gg, Gs^Fds, Gll, Gs^Fds, Gg, Gll^Efm, Gg^Efm, Gll, Gg, Gll, Gg, Gs^Fds, Wo, Gs^Fds, Wo, Gg, Wo, Gs^Fds, Wo, Gll, Gll, Gs^Fds, Gs^Fds, Gs^Fds
Ss, Wo, Wo, Ww, Gg^Edb, Gll, Cv, Gs^Fds, Gs^Fds, Gs^Fds, Gll, Gs^Fds, Gs^Fds, Gg^Efm, Gg, Gs^Fds, Gll, Gs^Fds, Gg, Gg, Ww, Gg^Efm, Ww, Gg, Wo, Wo, Ww, Wo, Ww, Wo, Ww, Wo, Wo, Wo, Wo^Bw/, Gll, Gll, Gs^Fds
Ss, Ss, Wo, Ww, Wo, Ww, Gg^Edb, Gg, Gg, Gs^Fds, Gs^Fds, Gll, Gll, Gs^Fds, Gs^Fds, Gll, Gll, Gs^Fds, Gg, Wo, Wo, Ww, Wo, Wo, Ww, Ww, Gll, Ww, Gg, Ww, Gg, Ww, Ww^Bw/, Wo^Bw/, Wwr, Wo, Wo, Gs^Fds
Gll^Fdw, Ss, Ss, Wo, Ss, Wo, Wo, Ww, Ww, Cv, Gs^Fds, Gs^Fds, Gs^Fds, Gll, Gll, Gll, Gg, Gg, Wwr, Wwr^Bw\, Wo^Bw\, Wo, Ww, Wo, Re, Re, Rb^Efs, Gd, Re, Gg, Gs, Gg, Gg, Ww, Wo, Wo, Gg, Gs^Fds
Gll^Fdw, Gll^Fdw, Ss, Ss, Wo, Wo, Ss, Wo, Wo, Ww, Ww, Cv, Wo, Gs^Fds, Ww, Cv, Ww, Ww, Wo, Wo, Gs, Gs, Gd, Gs, Ias^Efs, Ias^Efs, Ias, Rb^Efs, Ias^Efs, Re, Gg^Fet, Gs, Gg, Ww, Wo, Wo, Gs^Fds, Gll
Gll^Fdw, Gll^Fdw, Gll^Fdw, Ss, Ss, Wo, Wo, Wo, Ss, Wo, Wo, Ww, Wo, Ww, Ww, Ww, Ww, Ww, Wo, Wo, Gs, Gs, Gg^Fet, Gg, Rb^Efs, Rb, Ias, Ias, Ias^Efs, Re, Gs, Gs, Gg, Ww, Wo, Wo, Gs^Fds, Gs^Fds
Gll^Fdf, Gll^Fdw, Gd^Fetd, Ss, Ss, Ss, Ss, 3 Ss^Vhs, Ss, Ss, Wo, Wo, Wo, Wo, Wo, Wo, Wo, Ww, Wo, Wo, Gg, Gg, Gg, Gs, Gg, Rb^Efs, Rb^Efs, Ias^Efs, Gg, Gs, Gg, Gs, Wo, Ww, Wo, Gg, Gll, Gs^Fds
Gll^Fdf, Gll^Fdf, Gll^Fdf, Gll^Fdw, Gll^Fdw, Gll^Feth, Gll^Fdw, Ss, Gll^Fdw, Ss, Ss, Ss, Ss, Ss, Ss, Wo, Ss, Wo, Wo, Wo, Ww, Wwr, Ww, Gg, Ww, Gg, Wo, Gg, Wo, Gg, Ww, Wo, Wo, Wo, Gs^Fds, Gg, Gs^Fds, Gs^Fds
Gll^Fdw, Gll^Fdf, Gll^Fdf, Gll^Fdf, Gll^Fdf, Gll^Fdf, Gll^Fdf, Gll^Fdw, Gll^Fdw, Gll^Fdw, Gll^Fdw, Ss, Ss, Ss, Ss, Ss, Ss, Wo, Wo, Wo, Wo, Ww, Wo, Ww, Wo, Wo, Wo, Wo, Wo, Ww, Wo, Wo, Gg, Gll, Gs^Fds, Gs^Fds, Gs^Fds, Gs^Fds
